30 100
GTTCGTCAAGCCCCTGACACCCCCTTAAGT|TTCTTATGCCAGATATGATGAATAGGCCAC
TCCTTCTCGAGCGTAAAATTACGCTTACCC|GGTGGAAGTGTAAACCGTGTGGAAAGCGCC
GTTCCCACAGGTGGAAGTGTAAACACCCCG|GAGCGTAAAATTACGCTTACCCACTGGAAT
TTAACATGTTTGGGGATACGACTCGTACCG|ATACACCGTCCCCTTCGTTCCGCCTTCCAT
AGCGTAAAATTACGCTTACCCACTGGAATA|GTAAACCGTGTGGAAAGCGCCGGGCCTTGA
CGGACACATCTTCTGTACCCTATCACCTAC|GGTGGAAGTGTAAACCCTTCCCTGCGCCCG
GGGATACGACTCGTACCGATTGTTCGTCAA|CTTCGTTCCGCCTTCCATAGGTTCTTATGC
AGGTGGAAGTGTAAACAAATAGAGACGGTA|GTGTAAACTACTAACGGTCTAACGGTCCCT
ACTCTCTACCACATTCGGAACCACCGGCAT|TCGTACCGATTGTTCGTCAAGCCCCTGACA
CACCCCGGGTCCCCTGTTGACGGCACACAG|CTGGAATATGAGGTCTGACAGTATGCATCT
GAGGTCTGACAGTATGCATCTGCCTGGGCC|CGGGACCTGGTGGTCTCGAGTGTTGACGCC
GGCATGGTTCCCACAGGTGGAAGTGTAAAC|TCTGGTTCCCTGGGCATGGTTCGGCATGGT
TGGAAGTGTAAACGAACATTATACACCGTC|CGGAATAATGTATCGGGCATGGTTCCCACA
TTCGGCATGGTTCCCACAGGTGGAAGTGTA|GAAGTGTAAACCTCCGGACTCCCGGCCGTA
CCACAGGTGGAAGTGTAAACATGGTTCCCA|GGTTCCCACAGGTGGAAGTGTAAACAGTTC
TCCATAGGTTCTTATGCCAGATATGATGAA|AGAACCCTAAGGGCATGGTTCCCACAGGTG
GTGGAAGTGTAAACCTCCGGACTCCCGGCC|AGCCTCTGCTGAACCAGTGCGAAACATGGT
GATATGCTCGCAATTTATCTACCAGCACCA|AGAGACGGTAGCGTGAGGGCATGGTTCCCA
CCTTCGTTCCGCCTTCCATAGGTTCTTATG|GTGGAAGTGTAAACAGAACCCTAAGGGCAT
CACCGTCCCCTTCGTTCCGCCTTCCATAGG|TCCCACAGGTGGAAGTGTAAACAGAACCCT
CATGTCTATGACATTCCAGGCATGGTTCCC|ATCTCCTCGCGGCATGGTTCCCACAGGTGG
TAAAATTACGCTTACCCACTGGAATATGAG|ACCGTGTGGAAAGCGCCGGGCCTTGATCGG
CGTCTGGTTCCCTGGGCATGGTTCGGCATG|AAGGCATGGTTCCCACAGGTGGAAGTGTAA
TAGTACCACACTATAGGAGAAATTTACTAT|CAGGTGGAAGTGTAAACACCCCGGGTCCCC
TACGCTTACCCACTGGAATATGAGGTCTGA|TGGAAAGCGCCGGGCCTTGATCGGGACCTG
CCGCCTTCCATAGGTTCTTATGCCAGATAT|GTAAACAGAACCCTAAGGGCATGGTTCCCA
TGGGCCTGGCGGCATGGTTCCCACAGGTGG|ACCTACCCTTCTTCAGGCATGGTTCCCACA
TAGACGCAGAGAAATCCGCACAGATTTCGC|GTAAACGAGCGCGATAAGACACGTGGGCCT
CAGGTGGAAGTGTAAACAAATAGAGACGGT|AGTGTAAACTACTAACGGTCTAACGGTCCC
CGAGTGTTGACGCCAAAGGCATGGTTCCCA|GGGGCATGGTTCCCACAGGTGGAAGTGTAA
CGGTCCCTCAGGTTCCTTCTCGAGCGTAAA|GTGTAAACCCACAGGTGGAAGTGTAAACCG
AGGTGGAAGTGTAAACACCCCGGGTCCCCT|AATTACGCTTACCCACTGGAATATGAGGTC
AAGTGTAAACACCCCGGGTCCCCTGTTGAC|GCTTACCCACTGGAATATGAGGTCTGACAG
TCCCCTGTTGACGGCACACAGCGATCTCCT|GAGGTCTGACAGTATGCATCTGCCTGGGCC
ATGTATCGGGCATGGTTCCCACAGGTGGAA|CGCTGATGCCGACACCCGTCGAATCGTTAA
CCCTTCCCTGCGCCCGCGAAGATGGGGGGG|GCGGCAAACCTATATCTGGCATGGTTCCCA
TGGAAGTGTAAACGAGCGCGATAAGACACG|GTCATACGGACACATCTTCTGTACCCTATC
ACGAACATTATACACCGTCCCCTTCGTTCC|ATCGGGCATGGTTCCCACAGGTGGAAGTGT
CACAGGTGGAAGTGTAAACGAACATTATAC|GCACTCCGGAATAATGTATCGGGCATGGTT
CCCCTGACACCCCCTTAAGTGCTAGTCTTA|AGATATGATGAATAGGCCACCCTTGAGCGC
GTCCCTCAGGTTCCTTCTCGAGCGTAAAAT|GTAAACCCACAGGTGGAAGTGTAAACCGTG
TCCCACAGGTGGAAGTGTAAACAAATAGAG|GTGGAAGTGTAAACTACTAACGGTCTAACG
TCTCGAGCGTAAAATTACGCTTACCCACTG|GAAGTGTAAACCGTGTGGAAAGCGCCGGGC
GGGTCCCCTGTTGACGGCACACAGCGATCT|TATGAGGTCTGACAGTATGCATCTGCCTGG
AGTATCAGGATGCTTATTGAAGCCCGGGAC|GGAAGAGCGAGAGTGCGGTCAAGAGGAGGT
CGCGTCTGGTTCCCTGGGCATGGTTCGGCA|CAAAGGCATGGTTCCCACAGGTGGAAGTGT
ACTATAGGAGAAATTTACTATCCCCGGTTA|GTGTAAACACCCCGGGTCCCCTGTTGACGG
AACCAGCCTCTGCTGAACCAGTGCGAAACA|AACATGGTTCCCACAGGTGGAAGTGTAAAC
GAGCGCTAGTATCAGGATGCTTATTGAAGC|AATGTGGGGAAGAGCGAGAGTGCGGTCAAG
AGGTGGAAGTGTAAACATGGTTCCCACAGG|CCCACAGGTGGAAGTGTAAACAGTTCCGAT
CCCCCTTAAGTGCTAGTCTTAAAAGCGGCA|GAATAGGCCACCCTTGAGCGCTAGTATCAG
TGTAAACAGTTCCGATCCAGCTAAGGTCAC|TTGTGTTTAACATGTTTGGGGATACGACTC
GGTTCCCACAGGTGGAAGTGTAAACTACTA|TTCCCTGGGCATGGTTCGGCATGGTTCCCA
CCCACAGGTGGAAGTGTAAACAAATAGAGA|TGGAAGTGTAAACTACTAACGGTCTAACGG
GAATAATGTATCGGGCATGGTTCCCACAGG|ATCGTCGCTGATGCCGACACCCGTCGAATC
AAAGCGCCGGGCCTTGATCGGGACCTGGTG|TTGTAGACGCAGAGAAATCCGCACAGATTT
GGGGCATGGTTCCCACAGGTGGAAGTGTAA|GCGGCATGGTTCCCACAGGTGGAAGTGTAA
AAACCGTGTGGAAAGCGCCGGGCCTTGATC|GCTGACTTACGTTGTAGACGCAGAGAAATC
GGTCCCTCAGGTTCCTTCTCGAGCGTAAAA|TGTAAACCCACAGGTGGAAGTGTAAACCGT
GTACCCTATCACCTACCCTTCTTCAGGCAT|CCCTTCCCTGCGCCCGCGAAGATGGGGGGG
TGGGCCGCGTCTGGTTCCCTGGGCATGGTT|GACGCCAAAGGCATGGTTCCCACAGGTGGA
AAGGTCACTCTCTACCACATTCGGAACCAC|TACGACTCGTACCGATTGTTCGTCAAGCCC
GTTCCCACAGGTGGAAGTGTAAACCCACAG|ACCTCCGGACTCCCGGCCGTAAACACTGAT
CCCTTGAGCGCTAGTATCAGGATGCTTATT|AAACAAATGTGGGGAAGAGCGAGAGTGCGG
AGTCTTAAAAGCGGCAAACCTATATCTGGC|TGAGCGCTAGTATCAGGATGCTTATTGAAG
TGAGCGCTAGTATCAGGATGCTTATTGAAG|AAATGTGGGGAAGAGCGAGAGTGCGGTCAA
GGCATGGTTCCCACAGGTGGAAGTGTAAAC|AAGCCCGGGACGCACTCCGGAATAATGTAT
TTCCCACAGGTGGAAGTGTAAACCCACAGG|CCTCCGGACTCCCGGCCGTAAACACTGATC
CCACTGGAATATGAGGTCTGACAGTATGCA|CCGGGCCTTGATCGGGACCTGGTGGTCTCG
GGAGAAATTTACTATCCCCGGTTATCAGAG|ACACCCCGGGTCCCCTGTTGACGGCACACA
CTCGCGGCATGGTTCCCACAGGTGGAAGTG|CCGCGTCTGGTTCCCTGGGCATGGTTCGGC
GCAGAGAAATCCGCACAGATTTCGCGGGGG|CGAGCGCGATAAGACACGTGGGCCTGGCGG
AGCCTCTGCTGAACCAGTGCGAAACATGGT|TGGTTCCCACAGGTGGAAGTGTAAACTGGA
AGTAAAGAAGGCATGGTTCCCACAGGTGGA|CTATATGCTGACTAAAAACTGAATCAGTCA
CAGAGCGCCATGTCTATGACATTCCAGGCA|ACACAGCGATCTCCTCGCGGCATGGTTCCC
ACCCTTCCCTGCGCCCGCGAAGATGGGGGG|AGCGGCAAACCTATATCTGGCATGGTTCCC
TGTTGACGGCACACAGCGATCTCCTCGCGG|CTGACAGTATGCATCTGCCTGGGCCGCGTC
AGGTGGAAGTGTAAACGAGCGCGATAAGAC|TCAGTCATACGGACACATCTTCTGTACCCT
TGAGGTCTGACAGTATGCATCTGCCTGGGC|TCGGGACCTGGTGGTCTCGAGTGTTGACGC
TCTTAAAAGCGGCAAACCTATATCTGGCAT|AGCGCTAGTATCAGGATGCTTATTGAAGCC
GCGTCTGGTTCCCTGGGCATGGTTCGGCAT|AAAGGCATGGTTCCCACAGGTGGAAGTGTA
GAATCAGTCATACGGACACATCTTCTGTAC|ATGGTTCCCACAGGTGGAAGTGTAAACCCT
TTATGCCAGATATGATGAATAGGCCACCCT|GGCATGGTTCCCACAGGTGGAAGTGTAAAC
ATCAGAGCGCCATGTCTATGACATTCCAGG|GCACACAGCGATCTCCTCGCGGCATGGTTC
CCCGCTGACTTACGTTGTAGACGCAGAGAA|TTCCCACAGGTGGAAGTGTAAACGAGCGCG
ACACTATAGGAGAAATTTACTATCCCCGGT|AAGTGTAAACACCCCGGGTCCCCTGTTGAC
GTCAAGCCCCTGACACCCCCTTAAGTGCTA|TATGCCAGATATGATGAATAGGCCACCCTT
TCTTCTGTACCCTATCACCTACCCTTCTTC|TGTAAACCCTTCCCTGCGCCCGCGAAGATG
GAGCGTAAAATTACGCTTACCCACTGGAAT|TGTAAACCGTGTGGAAAGCGCCGGGCCTTG
TGTAAACAAATAGAGACGGTAGCGTGAGGG|ACTAACGGTCTAACGGTCCCTCAGGTTCCT
GCATGGTTCCCACAGGTGGAAGTGTAAACG|AGCCCGGGACGCACTCCGGAATAATGTATC
GGACCTGGTGGTCTCGAGTGTTGACGCCAA|GCACAGATTTCGCGGGGGCATGGTTCCCAC
GCGATCTCCTCGCGGCATGGTTCCCACAGG|TGCCTGGGCCGCGTCTGGTTCCCTGGGCAT
ATGGTTCCCACAGGTGGAAGTGTAAACAAA|CACAGGTGGAAGTGTAAACTACTAACGGTC
ACCCACTGGAATATGAGGTCTGACAGTATG|CGCCGGGCCTTGATCGGGACCTGGTGGTCT
GGAAGTGTAAACAGTTCCGATCCAGCTAAG|AATTGTTGTGTTTAACATGTTTGGGGATAC
ATGGGGGGGATGGCACATCTTTAATTGTTG|TGGTTCCCACAGGTGGAAGTGTAAACGAAC
CTAAAAACTGAATCAGTCATACGGACACAT|ACCACCGGCATGGTTCCCACAGGTGGAAGT
TGTACCCTATCACCTACCCTTCTTCAGGCA|ACCCTTCCCTGCGCCCGCGAAGATGGGGGG
CGTAAAATTACGCTTACCCACTGGAATATG|AAACCGTGTGGAAAGCGCCGGGCCTTGATC
CCACAGGTGGAAGTGTAAACGAACATTATA|CGCACTCCGGAATAATGTATCGGGCATGGT
ACTACTAACGGTCTAACGGTCCCTCAGGTT|GTTCCCACAGGTGGAAGTGTAAACCCACAG
TTCGTTCCGCCTTCCATAGGTTCTTATGCC|GGAAGTGTAAACAGAACCCTAAGGGCATGG
TGTAAACGAGCGCGATAAGACACGTGGGCC|CGGACACATCTTCTGTACCCTATCACCTAC
AGGTGGAAGTGTAAACAGTTCCGATCCAGC|CTTTAATTGTTGTGTTTAACATGTTTGGGG
TACACCGTCCCCTTCGTTCCGCCTTCCATA|GTTCCCACAGGTGGAAGTGTAAACAGAACC
AGGAGAAATTTACTATCCCCGGTTATCAGA|AACACCCCGGGTCCCCTGTTGACGGCACAC
GTATCAGGATGCTTATTGAAGCCCGGGACG|GAAGAGCGAGAGTGCGGTCAAGAGGAGGTG
TCTCTACCACATTCGGAACCACCGGCATGG|GTACCGATTGTTCGTCAAGCCCCTGACACC
ACAGATTTCGCGGGGGCATGGTTCCCACAG|CACGTGGGCCTGGCGGCATGGTTCCCACAG
TTATACACCGTCCCCTTCGTTCCGCCTTCC|ATGGTTCCCACAGGTGGAAGTGTAAACAGA
CGATTGTTCGTCAAGCCCCTGACACCCCCT|ATAGGTTCTTATGCCAGATATGATGAATAG
ACATCTTTAATTGTTGTGTTTAACATGTTT|GGAAGTGTAAACGAACATTATACACCGTCC
TACCGATTGTTCGTCAAGCCCCTGACACCC|TCCATAGGTTCTTATGCCAGATATGATGAA
TGTTTGGGGATACGACTCGTACCGATTGTT|CGTCCCCTTCGTTCCGCCTTCCATAGGTTC
TGGGAGTAAAGAAGGCATGGTTCCCACAGG|ACCTCTATATGCTGACTAAAAACTGAATCA
GGCATGGTTCGGCATGGTTCCCACAGGTGG|ACAGGTGGAAGTGTAAACCTCCGGACTCCC
GCTAGTATCAGGATGCTTATTGAAGCCCGG|TGGGGAAGAGCGAGAGTGCGGTCAAGAGGA
CGGCATGGTTCCCACAGGTGGAAGTGTAAA|TCTTCAGGCATGGTTCCCACAGGTGGAAGT
GGTTCCCACAGGTGGAAGTGTAAACTGGAC|AACAGTTCCGATCCAGCTAAGGTCACTCTC
CACAGATTTCGCGGGGGCATGGTTCCCACA|ACACGTGGGCCTGGCGGCATGGTTCCCACA
CTGCGCCCGCGAAGATGGGGGGGATGGCAC|ACCTATATCTGGCATGGTTCCCACAGGTGG
TTCCCACAGGTGGAAGTGTAAACTACTAAC|CCCTGGGCATGGTTCGGCATGGTTCCCACA
GTTCCCACAGGTGGAAGTGTAAACGAACAT|GGGACGCACTCCGGAATAATGTATCGGGCA
GGAAGTGTAAACCCTTCCCTGCGCCCGCGA|TAGTCTTAAAAGCGGCAAACCTATATCTGG
TTCCCACAGGTGGAAGTGTAAACCTCCGGA|GTGTAAACCAGCCTCTGCTGAACCAGTGCG
CGTCCCCTTCGTTCCGCCTTCCATAGGTTC|CACAGGTGGAAGTGTAAACAGAACCCTAAG
CGAGCGCGATAAGACACGTGGGCCTGGCGG|CATCTTCTGTACCCTATCACCTACCCTTCT
TCTCCTCGCGGCATGGTTCCCACAGGTGGA|TGGGCCGCGTCTGGTTCCCTGGGCATGGTT
GGTCCCCTGTTGACGGCACACAGCGATCTC|ATGAGGTCTGACAGTATGCATCTGCCTGGG
AGTCATACGGACACATCTTCTGTACCCTAT|TCCCACAGGTGGAAGTGTAAACCCTTCCCT
AACCCACAGGTGGAAGTGTAAACCGTGTGG|AACACTGATCTATACGCCCGCTGACTTACG
GGAAGTGTAAACAAATAGAGACGGTAGCGT|AAACTACTAACGGTCTAACGGTCCCTCAGG
GCATGGTTCCCACAGGTGGAAGTGTAAACC|GTGGAAGTGTAAACCAGCCTCTGCTGAACC
AGTGTAAACAGTTCCGATCCAGCTAAGGTC|TGTTGTGTTTAACATGTTTGGGGATACGAC
CCTTCCATAGGTTCTTATGCCAGATATGAT|AACAGAACCCTAAGGGCATGGTTCCCACAG
TGGAAGTGTAAACCGTGTGGAAAGCGCCGG|TATACGCCCGCTGACTTACGTTGTAGACGC
TCAAGCCCCTGACACCCCCTTAAGTGCTAG|ATGCCAGATATGATGAATAGGCCACCCTTG
ATAGTACCACACTATAGGAGAAATTTACTA|ACAGGTGGAAGTGTAAACACCCCGGGTCCC
CGGCCGTAAACACTGATCTATACGCCCGCT|ATGGTGGGAGTAAAGAAGGCATGGTTCCCA
TTCCCACAGGTGGAAGTGTAAACGAACATT|GGACGCACTCCGGAATAATGTATCGGGCAT
CTGGCATGGTTCCCACAGGTGGAAGTGTAA|TGAAGCCCGGGACGCACTCCGGAATAATGT
TGCTGACTAAAAACTGAATCAGTCATACGG|TTCGGAACCACCGGCATGGTTCCCACAGGT
CCACAGGTGGAAGTGTAAACTACTAACGGT|TGGGCATGGTTCGGCATGGTTCCCACAGGT
ATGGTTCCCACAGGTGGAAGTGTAAACCCA|TAAACCTCCGGACTCCCGGCCGTAAACACT
GCCAAAGGCATGGTTCCCACAGGTGGAAGT|CCCACAGGTGGAAGTGTAAACCAGCCTCTG
GCTAAGGTCACTCTCTACCACATTCGGAAC|GGATACGACTCGTACCGATTGTTCGTCAAG
GTGGAAGTGTAAACCCTTCCCTGCGCCCGC|GCTAGTCTTAAAAGCGGCAAACCTATATCT
GTCTGACAGTATGCATCTGCCTGGGCCGCG|GACCTGGTGGTCTCGAGTGTTGACGCCAAA
GAGAAATTTACTATCCCCGGTTATCAGAGC|CACCCCGGGTCCCCTGTTGACGGCACACAG
CTCGCAATTTATCTACCAGCACCATAGTAC|GGTAGCGTGAGGGCATGGTTCCCACAGGTG
CCAAAGGCATGGTTCCCACAGGTGGAAGTG|CCACAGGTGGAAGTGTAAACCAGCCTCTGC
CCCGGCCGTAAACACTGATCTATACGCCCG|ACATGGTGGGAGTAAAGAAGGCATGGTTCC
TGGTGGTCTCGAGTGTTGACGCCAAAGGCA|GATTTCGCGGGGGCATGGTTCCCACAGGTG
CAGGCATGGTTCCCACAGGTGGAAGTGTAA|GTTCCCACAGGTGGAAGTGTAAACTACTAA
AAATTACGCTTACCCACTGGAATATGAGGT|CGTGTGGAAAGCGCCGGGCCTTGATCGGGA
GCATGGTTCCCACAGGTGGAAGTGTAAACC|GACACCCCCTTAAGTGCTAGTCTTAAAAGC
AAAATTACGCTTACCCACTGGAATATGAGG|CCGTGTGGAAAGCGCCGGGCCTTGATCGGG
CATCTGCCTGGGCCGCGTCTGGTTCCCTGG|CGAGTGTTGACGCCAAAGGCATGGTTCCCA
TTGTGTTTAACATGTTTGGGGATACGACTC|AACATTATACACCGTCCCCTTCGTTCCGCC
CTCCGGAATAATGTATCGGGCATGGTTCCC|CTTGGATCGTCGCTGATGCCGACACCCGTC
GGTGGAAGTGTAAACAAATAGAGACGGTAG|TGTAAACTACTAACGGTCTAACGGTCCCTC
TTCCCACAGGTGGAAGTGTAAACAGAACCC|CCGTCGAATCGTTAAAGATCAGGCCTCAAT
TAAACATGGTTCCCACAGGTGGAAGTGTAA|AAGTGTAAACAGTTCCGATCCAGCTAAGGT
TGGTTCCCACAGGTGGAAGTGTAAACAAAT|ACAGGTGGAAGTGTAAACTACTAACGGTCT
TGTGGAAAGCGCCGGGCCTTGATCGGGACC|TTACGTTGTAGACGCAGAGAAATCCGCACA
ATACACCGTCCCCTTCGTTCCGCCTTCCAT|GGTTCCCACAGGTGGAAGTGTAAACAGAAC
CTGACTAAAAACTGAATCAGTCATACGGAC|CGGAACCACCGGCATGGTTCCCACAGGTGG
TCTGACAGTATGCATCTGCCTGGGCCGCGT|ACCTGGTGGTCTCGAGTGTTGACGCCAAAG
GTTCCCTGGGCATGGTTCGGCATGGTTCCC|TGGTTCCCACAGGTGGAAGTGTAAACCTCC
TCCCACAGGTGGAAGTGTAAACACCCCGGG|GCGTAAAATTACGCTTACCCACTGGAATAT
CTTCGTTCCGCCTTCCATAGGTTCTTATGC|TGGAAGTGTAAACAGAACCCTAAGGGCATG
CCTCTGCTGAACCAGTGCGAAACATGGTGG|GTTCCCACAGGTGGAAGTGTAAACTGGACC
AAGTGCTAGTCTTAAAAGCGGCAAACCTAT|CCACCCTTGAGCGCTAGTATCAGGATGCTT
CACCATAGTACCACACTATAGGAGAAATTT|TCCCACAGGTGGAAGTGTAAACACCCCGGG
CATGGTTCCCACAGGTGGAAGTGTAAACCC|GTAAACCTCCGGACTCCCGGCCGTAAACAC
ACGGTAGCGTGAGGGCATGGTTCCCACAGG|GTCCCTCAGGTTCCTTCTCGAGCGTAAAAT
GTGTAAACTGGACCTCTATATGCTGACTAA|TAAGGTCACTCTCTACCACATTCGGAACCA
CGCACTCCGGAATAATGTATCGGGCATGGT|TGTCCTTGGATCGTCGCTGATGCCGACACC
ATCTTCTGTACCCTATCACCTACCCTTCTT|GTGTAAACCCTTCCCTGCGCCCGCGAAGAT
CCCACAGGTGGAAGTGTAAACGAACATTAT|ACGCACTCCGGAATAATGTATCGGGCATGG
GGTTCGGCATGGTTCCCACAGGTGGAAGTG|TGGAAGTGTAAACCTCCGGACTCCCGGCCG
CTACCAGCACCATAGTACCACACTATAGGA|GCATGGTTCCCACAGGTGGAAGTGTAAACA
CAAGCCCCTGACACCCCCTTAAGTGCTAGT|TGCCAGATATGATGAATAGGCCACCCTTGA
AGGATGCTTATTGAAGCCCGGGACGCACTC|GCGAGAGTGCGGTCAAGAGGAGGTGTCCTT
CACAGGTGGAAGTGTAAACCCACAGGTGGA|CGGACTCCCGGCCGTAAACACTGATCTATA
ATATCTGGCATGGTTCCCACAGGTGGAAGT|TTATTGAAGCCCGGGACGCACTCCGGAATA
AAGCGGCAAACCTATATCTGGCATGGTTCC|AGTATCAGGATGCTTATTGAAGCCCGGGAC
CCACAGGTGGAAGTGTAAACGAGCGCGATA|TGAATCAGTCATACGGACACATCTTCTGTA
CTGACAGTATGCATCTGCCTGGGCCGCGTC|CCTGGTGGTCTCGAGTGTTGACGCCAAAGG
CACCCTTGAGCGCTAGTATCAGGATGCTTA|GTAAACAAATGTGGGGAAGAGCGAGAGTGC
CTATGACATTCCAGGCATGGTTCCCACAGG|CTCGCGGCATGGTTCCCACAGGTGGAAGTG
AAACTACTAACGGTCTAACGGTCCCTCAGG|TGGTTCCCACAGGTGGAAGTGTAAACCCAC
GTTCTTATGCCAGATATGATGAATAGGCCA|TAAGGGCATGGTTCCCACAGGTGGAAGTGT
GGGCCTTGATCGGGACCTGGTGGTCTCGAG|GCAGAGAAATCCGCACAGATTTCGCGGGGG
TGAATAGGCCACCCTTGAGCGCTAGTATCA|GGTGGAAGTGTAAACAAATGTGGGGAAGAG
CATTCCAGGCATGGTTCCCACAGGTGGAAG|GCATGGTTCCCACAGGTGGAAGTGTAAACT
CCCGGGACGCACTCCGGAATAATGTATCGG|GAGGAGGTGTCCTTGGATCGTCGCTGATGC
GTAAACCTCCGGACTCCCGGCCGTAAACAC|CTGAACCAGTGCGAAACATGGTGGGAGTAA
CAGGTGGAAGTGTAAACAGTTCCGATCCAG|TCTTTAATTGTTGTGTTTAACATGTTTGGG
CCGGGTCCCCTGTTGACGGCACACAGCGAT|AATATGAGGTCTGACAGTATGCATCTGCCT
TGTATCGGGCATGGTTCCCACAGGTGGAAG|GCTGATGCCGACACCCGTCGAATCGTTAAA
GCTTATTGAAGCCCGGGACGCACTCCGGAA|AGTGCGGTCAAGAGGAGGTGTCCTTGGATC
CACAGGTGGAAGTGTAAACCGTGTGGAAAG|CTGATCTATACGCCCGCTGACTTACGTTGT
CGGCACACAGCGATCTCCTCGCGGCATGGT|GTATGCATCTGCCTGGGCCGCGTCTGGTTC
GTTCCCACAGGTGGAAGTGTAAACAAATAG|AGGTGGAAGTGTAAACTACTAACGGTCTAA
TTAAGTGCTAGTCTTAAAAGCGGCAAACCT|GGCCACCCTTGAGCGCTAGTATCAGGATGC
ACCCCGGGTCCCCTGTTGACGGCACACAGC|TGGAATATGAGGTCTGACAGTATGCATCTG
GGTGGTCTCGAGTGTTGACGCCAAAGGCAT|ATTTCGCGGGGGCATGGTTCCCACAGGTGG
GCGAAACATGGTGGGAGTAAAGAAGGCATG|GTGTAAACTGGACCTCTATATGCTGACTAA
TGTAAACCCTTCCCTGCGCCCGCGAAGATG|TTAAAAGCGGCAAACCTATATCTGGCATGG
AACCTATATCTGGCATGGTTCCCACAGGTG|GATGCTTATTGAAGCCCGGGACGCACTCCG
GATATGATGAATAGGCCACCCTTGAGCGCT|TCCCACAGGTGGAAGTGTAAACAAATGTGG
GTAAACAAATAGAGACGGTAGCGTGAGGGC|CTAACGGTCTAACGGTCCCTCAGGTTCCTT
TATGATGAATAGGCCACCCTTGAGCGCTAG|CCACAGGTGGAAGTGTAAACAAATGTGGGG
TTCCATAGGTTCTTATGCCAGATATGATGA|CAGAACCCTAAGGGCATGGTTCCCACAGGT
GTAAACAGTTCCGATCCAGCTAAGGTCACT|TGTGTTTAACATGTTTGGGGATACGACTCG
ATGGTTCCCACAGGTGGAAGTGTAAACAGA|ACACCCGTCGAATCGTTAAAGATCAGGCCT
CATGGTTCCCACAGGTGGAAGTGTAAACAA|CCACAGGTGGAAGTGTAAACTACTAACGGT
GTATCGGGCATGGTTCCCACAGGTGGAAGT|CTGATGCCGACACCCGTCGAATCGTTAAAG
ACGCAGAGAAATCCGCACAGATTTCGCGGG|AACGAGCGCGATAAGACACGTGGGCCTGGC
TGACGCCAAAGGCATGGTTCCCACAGGTGG|GGTTCCCACAGGTGGAAGTGTAAACCAGCC
CAGGTGGAAGTGTAAACATGGTTCCCACAG|TCCCACAGGTGGAAGTGTAAACAGTTCCGA
CACAGGTGGAAGTGTAAACTACTAACGGTC|GGGCATGGTTCGGCATGGTTCCCACAGGTG
CTGGTGGTCTCGAGTGTTGACGCCAAAGGC|AGATTTCGCGGGGGCATGGTTCCCACAGGT
AAGTGTAAACAAATAGAGACGGTAGCGTGA|ACTACTAACGGTCTAACGGTCCCTCAGGTT
CTAACGGTCTAACGGTCCCTCAGGTTCCTT|CCACAGGTGGAAGTGTAAACCCACAGGTGG
CTGAACCAGTGCGAAACATGGTGGGAGTAA|ACAGGTGGAAGTGTAAACTGGACCTCTATA
GCGTGAGGGCATGGTTCCCACAGGTGGAAG|CAGGTTCCTTCTCGAGCGTAAAATTACGCT
GTTGTAGACGCAGAGAAATCCGCACAGATT|AAGTGTAAACGAGCGCGATAAGACACGTGG
CAATTTATCTACCAGCACCATAGTACCACA|GCGTGAGGGCATGGTTCCCACAGGTGGAAG
AATAATGTATCGGGCATGGTTCCCACAGGT|TCGTCGCTGATGCCGACACCCGTCGAATCG
ACTATCCCCGGTTATCAGAGCGCCATGTCT|TCCCCTGTTGACGGCACACAGCGATCTCCT
GGGACCTGGTGGTCTCGAGTGTTGACGCCA|CGCACAGATTTCGCGGGGGCATGGTTCCCA
CCTGTTGACGGCACACAGCGATCTCCTCGC|GTCTGACAGTATGCATCTGCCTGGGCCGCG
CCCGCGAAGATGGGGGGGATGGCACATCTT|TATCTGGCATGGTTCCCACAGGTGGAAGTG
TTCGTCAAGCCCCTGACACCCCCTTAAGTG|TCTTATGCCAGATATGATGAATAGGCCACC
TTCCCACAGGTGGAAGTGTAAACACCCCGG|AGCGTAAAATTACGCTTACCCACTGGAATA
CCTACCCTTCTTCAGGCATGGTTCCCACAG|GCCCGCGAAGATGGGGGGGATGGCACATCT
CATGGTTCCCACAGGTGGAAGTGTAAACCC|ACACCCCCTTAAGTGCTAGTCTTAAAAGCG
TGACATTCCAGGCATGGTTCCCACAGGTGG|GCGGCATGGTTCCCACAGGTGGAAGTGTAA
AAGTGTAAACGAACATTATACACCGTCCCC|AATAATGTATCGGGCATGGTTCCCACAGGT
TCCCACAGGTGGAAGTGTAAACGAGCGCGA|ACTGAATCAGTCATACGGACACATCTTCTG
GAAGTGTAAACCCACAGGTGGAAGTGTAAA|CGGCCGTAAACACTGATCTATACGCCCGCT
GCGGCAAACCTATATCTGGCATGGTTCCCA|TATCAGGATGCTTATTGAAGCCCGGGACGC
CACCTACCCTTCTTCAGGCATGGTTCCCAC|GCGCCCGCGAAGATGGGGGGGATGGCACAT
ATTGTTGTGTTTAACATGTTTGGGGATACG|AACGAACATTATACACCGTCCCCTTCGTTC
ACACAGCGATCTCCTCGCGGCATGGTTCCC|GCATCTGCCTGGGCCGCGTCTGGTTCCCTG
TGGTTCCCACAGGTGGAAGTGTAAACTACT|GTTCCCTGGGCATGGTTCGGCATGGTTCCC
TGGTTCCCACAGGTGGAAGTGTAAACAGTT|GATGGCACATCTTTAATTGTTGTGTTTAAC
AAACCTATATCTGGCATGGTTCCCACAGGT|GGATGCTTATTGAAGCCCGGGACGCACTCC
GAAGTGTAAACAAATAGAGACGGTAGCGTG|AACTACTAACGGTCTAACGGTCCCTCAGGT
TTAATTGTTGTGTTTAACATGTTTGGGGAT|GTAAACGAACATTATACACCGTCCCCTTCG
AACACTGATCTATACGCCCGCTGACTTACG|AGTAAAGAAGGCATGGTTCCCACAGGTGGA
TGGAAGTGTAAACCTCCGGACTCCCGGCCG|GCCTCTGCTGAACCAGTGCGAAACATGGTG
CTCTACCACATTCGGAACCACCGGCATGGT|TACCGATTGTTCGTCAAGCCCCTGACACCC
AAGTGTAAACCCACAGGTGGAAGTGTAAAC|GGCCGTAAACACTGATCTATACGCCCGCTG
CCGGCCGTAAACACTGATCTATACGCCCGC|CATGGTGGGAGTAAAGAAGGCATGGTTCCC
CGGAATAATGTATCGGGCATGGTTCCCACA|GGATCGTCGCTGATGCCGACACCCGTCGAA
GTAAACTGGACCTCTATATGCTGACTAAAA|AGGTCACTCTCTACCACATTCGGAACCACC
TGGTTCCCACAGGTGGAAGTGTAAACCCAC|AAACCTCCGGACTCCCGGCCGTAAACACTG
CAGGTGGAAGTGTAAACGAACATTATACAC|ACTCCGGAATAATGTATCGGGCATGGTTCC
GCACTCCGGAATAATGTATCGGGCATGGTT|GTCCTTGGATCGTCGCTGATGCCGACACCC
TCTGTACCCTATCACCTACCCTTCTTCAGG|AAACCCTTCCCTGCGCCCGCGAAGATGGGG
GCGCCCGCGAAGATGGGGGGGATGGCACAT|CTATATCTGGCATGGTTCCCACAGGTGGAA
CTTCAGGCATGGTTCCCACAGGTGGAAGTG|GATGGGGGGGATGGCACATCTTTAATTGTT
AATCAGTCATACGGACACATCTTCTGTACC|TGGTTCCCACAGGTGGAAGTGTAAACCCTT
GGTAGCGTGAGGGCATGGTTCCCACAGGTG|CCCTCAGGTTCCTTCTCGAGCGTAAAATTA
CTATATGCTGACTAAAAACTGAATCAGTCA|CCACATTCGGAACCACCGGCATGGTTCCCA
AGTGTAAACTACTAACGGTCTAACGGTCCC|CGGCATGGTTCCCACAGGTGGAAGTGTAAA
CGTCAAGCCCCTGACACCCCCTTAAGTGCT|TTATGCCAGATATGATGAATAGGCCACCCT
TGGAAGTGTAAACCAGCCTCTGCTGAACCA|TGGAAGTGTAAACATGGTTCCCACAGGTGG
TTCGGAACCACCGGCATGGTTCCCACAGGT|TCGTCAAGCCCCTGACACCCCCTTAAGTGC
AGGCCACCCTTGAGCGCTAGTATCAGGATG|AAGTGTAAACAAATGTGGGGAAGAGCGAGA
TCAGGTTCCTTCTCGAGCGTAAAATTACGC|CCCACAGGTGGAAGTGTAAACCGTGTGGAA
GCATGGTTCCCACAGGTGGAAGTGTAAACA|CCCACAGGTGGAAGTGTAAACTACTAACGG
AACATGGTTCCCACAGGTGGAAGTGTAAAC|GTGTAAACAGTTCCGATCCAGCTAAGGTCA
CATTATACACCGTCCCCTTCGTTCCGCCTT|GCATGGTTCCCACAGGTGGAAGTGTAAACA
TGACTAAAAACTGAATCAGTCATACGGACA|GGAACCACCGGCATGGTTCCCACAGGTGGA
CCTTCTCGAGCGTAAAATTACGCTTACCCA|GTGGAAGTGTAAACCGTGTGGAAAGCGCCG
GGAAGTGTAAACCCACAGGTGGAAGTGTAA|CCGGCCGTAAACACTGATCTATACGCCCGC
AGGCATGGTTCCCACAGGTGGAAGTGTAAA|TGACTAAAAACTGAATCAGTCATACGGACA
CGTAAACACTGATCTATACGCCCGCTGACT|TGGGAGTAAAGAAGGCATGGTTCCCACAGG
AAGAAGGCATGGTTCCCACAGGTGGAAGTG|ATGCTGACTAAAAACTGAATCAGTCATACG
CTCGAGTGTTGACGCCAAAGGCATGGTTCC|CGGGGGCATGGTTCCCACAGGTGGAAGTGT
TCCAGCTAAGGTCACTCTCTACCACATTCG|TTGGGGATACGACTCGTACCGATTGTTCGT
CAGGTGGAAGTGTAAACGAGCGCGATAAGA|ATCAGTCATACGGACACATCTTCTGTACCC
ACGTGGGCCTGGCGGCATGGTTCCCACAGG|ATCACCTACCCTTCTTCAGGCATGGTTCCC
ACATTCGGAACCACCGGCATGGTTCCCACA|TGTTCGTCAAGCCCCTGACACCCCCTTAAG
AAGACACGTGGGCCTGGCGGCATGGTTCCC|ACCCTATCACCTACCCTTCTTCAGGCATGG
CCCACAGGTGGAAGTGTAAACCCACAGGTG|TCCGGACTCCCGGCCGTAAACACTGATCTA
TAAACTGGACCTCTATATGCTGACTAAAAA|GGTCACTCTCTACCACATTCGGAACCACCG
TCCCCTTCGTTCCGCCTTCCATAGGTTCTT|CAGGTGGAAGTGTAAACAGAACCCTAAGGG
AAACCCTTCCCTGCGCCCGCGAAGATGGGG|AAAGCGGCAAACCTATATCTGGCATGGTTC
GACGGCACACAGCGATCTCCTCGCGGCATG|CAGTATGCATCTGCCTGGGCCGCGTCTGGT
ACAGGTGGAAGTGTAAACTACTAACGGTCT|GGCATGGTTCGGCATGGTTCCCACAGGTGG
GTGTAAACATGGTTCCCACAGGTGGAAGTG|TGGAAGTGTAAACAGTTCCGATCCAGCTAA
TAACGGTCCCTCAGGTTCCTTCTCGAGCGT|GAAGTGTAAACCCACAGGTGGAAGTGTAAA
AACAGTTCCGATCCAGCTAAGGTCACTCTC|GTTTAACATGTTTGGGGATACGACTCGTAC
TCCGATCCAGCTAAGGTCACTCTCTACCAC|CATGTTTGGGGATACGACTCGTACCGATTG
GTTCCTTCTCGAGCGTAAAATTACGCTTAC|CAGGTGGAAGTGTAAACCGTGTGGAAAGCG
ACTGGAATATGAGGTCTGACAGTATGCATC|GGGCCTTGATCGGGACCTGGTGGTCTCGAG
GGTCTGACAGTATGCATCTGCCTGGGCCGC|GGACCTGGTGGTCTCGAGTGTTGACGCCAA
ACATGTTTGGGGATACGACTCGTACCGATT|CACCGTCCCCTTCGTTCCGCCTTCCATAGG
CCCGGGTCCCCTGTTGACGGCACACAGCGA|GAATATGAGGTCTGACAGTATGCATCTGCC
CTACCCTTCTTCAGGCATGGTTCCCACAGG|CCCGCGAAGATGGGGGGGATGGCACATCTT
CTTCTTCAGGCATGGTTCCCACAGGTGGAA|GAAGATGGGGGGGATGGCACATCTTTAATT
GGAAGTGTAAACACCCCGGGTCCCCTGTTG|ACGCTTACCCACTGGAATATGAGGTCTGAC
GTGTGGAAAGCGCCGGGCCTTGATCGGGAC|CTTACGTTGTAGACGCAGAGAAATCCGCAC
TATCAGGATGCTTATTGAAGCCCGGGACGC|AAGAGCGAGAGTGCGGTCAAGAGGAGGTGT
ACAGGTGGAAGTGTAAACAGTTCCGATCCA|ATCTTTAATTGTTGTGTTTAACATGTTTGG
TTGTTGTGTTTAACATGTTTGGGGATACGA|ACGAACATTATACACCGTCCCCTTCGTTCC
AGGTGGAAGTGTAAACTACTAACGGTCTAA|CATGGTTCGGCATGGTTCCCACAGGTGGAA
GTGAGGGCATGGTTCCCACAGGTGGAAGTG|GGTTCCTTCTCGAGCGTAAAATTACGCTTA
GTAAAATTACGCTTACCCACTGGAATATGA|AACCGTGTGGAAAGCGCCGGGCCTTGATCG
TGTAAACTGGACCTCTATATGCTGACTAAA|AAGGTCACTCTCTACCACATTCGGAACCAC
CCCCGGGTCCCCTGTTGACGGCACACAGCG|GGAATATGAGGTCTGACAGTATGCATCTGC
GTGGAAGTGTAAACGAACATTATACACCGT|CCGGAATAATGTATCGGGCATGGTTCCCAC
GACATTCCAGGCATGGTTCCCACAGGTGGA|CGGCATGGTTCCCACAGGTGGAAGTGTAAA
CCAGTGCGAAACATGGTGGGAGTAAAGAAG|TGGAAGTGTAAACTGGACCTCTATATGCTG
TGTAAACCCACAGGTGGAAGTGTAAACCGT|CGTAAACACTGATCTATACGCCCGCTGACT
TCTGCCTGGGCCGCGTCTGGTTCCCTGGGC|AGTGTTGACGCCAAAGGCATGGTTCCCACA
ATGCTGACTAAAAACTGAATCAGTCATACG|ATTCGGAACCACCGGCATGGTTCCCACAGG
TGATGAATAGGCCACCCTTGAGCGCTAGTA|ACAGGTGGAAGTGTAAACAAATGTGGGGAA
TATAGGAGAAATTTACTATCCCCGGTTATC|GTAAACACCCCGGGTCCCCTGTTGACGGCA
TATCGGGCATGGTTCCCACAGGTGGAAGTG|TGATGCCGACACCCGTCGAATCGTTAAAGA
GGCCACCCTTGAGCGCTAGTATCAGGATGC|AGTGTAAACAAATGTGGGGAAGAGCGAGAG
TGCTTATTGAAGCCCGGGACGCACTCCGGA|GAGTGCGGTCAAGAGGAGGTGTCCTTGGAT
ACCCACAGGTGGAAGTGTAAACCGTGTGGA|ACACTGATCTATACGCCCGCTGACTTACGT
ACCCCCTTAAGTGCTAGTCTTAAAAGCGGC|TGAATAGGCCACCCTTGAGCGCTAGTATCA
TCCGGACTCCCGGCCGTAAACACTGATCTA|AGTGCGAAACATGGTGGGAGTAAAGAAGGC
AAAAACTGAATCAGTCATACGGACACATCT|CACCGGCATGGTTCCCACAGGTGGAAGTGT
GGTGGAAGTGTAAACGAGCGCGATAAGACA|CAGTCATACGGACACATCTTCTGTACCCTA
GTGTAAACCAGCCTCTGCTGAACCAGTGCG|GTGTAAACATGGTTCCCACAGGTGGAAGTG
TGGAAGTGTAAACCCTTCCCTGCGCCCGCG|CTAGTCTTAAAAGCGGCAAACCTATATCTG
ATCCGCACAGATTTCGCGGGGGCATGGTTC|ATAAGACACGTGGGCCTGGCGGCATGGTTC
CGAACATTATACACCGTCCCCTTCGTTCCG|TCGGGCATGGTTCCCACAGGTGGAAGTGTA
GGAAGTGTAAACATGGTTCCCACAGGTGGA|CAGGTGGAAGTGTAAACAGTTCCGATCCAG
CCTGCGCCCGCGAAGATGGGGGGGATGGCA|AACCTATATCTGGCATGGTTCCCACAGGTG
AAGTGTAAACATGGTTCCCACAGGTGGAAG|GGTGGAAGTGTAAACAGTTCCGATCCAGCT
CGGGTCCCCTGTTGACGGCACACAGCGATC|ATATGAGGTCTGACAGTATGCATCTGCCTG
ACAGGTGGAAGTGTAAACATGGTTCCCACA|TTCCCACAGGTGGAAGTGTAAACAGTTCCG
ACTAAAAACTGAATCAGTCATACGGACACA|AACCACCGGCATGGTTCCCACAGGTGGAAG
CTGGACCTCTATATGCTGACTAAAAACTGA|ACTCTCTACCACATTCGGAACCACCGGCAT
CTGGGCATGGTTCGGCATGGTTCCCACAGG|CCCACAGGTGGAAGTGTAAACCTCCGGACT
CCCCTTCGTTCCGCCTTCCATAGGTTCTTA|AGGTGGAAGTGTAAACAGAACCCTAAGGGC
GAACCACCGGCATGGTTCCCACAGGTGGAA|CAAGCCCCTGACACCCCCTTAAGTGCTAGT
TATATCTGGCATGGTTCCCACAGGTGGAAG|CTTATTGAAGCCCGGGACGCACTCCGGAAT
GACTCCCGGCCGTAAACACTGATCTATACG|CGAAACATGGTGGGAGTAAAGAAGGCATGG
GCATGGTTCCCACAGGTGGAAGTGTAAACA|CGACACCCGTCGAATCGTTAAAGATCAGGC
CTGGTTCCCTGGGCATGGTTCGGCATGGTT|GCATGGTTCCCACAGGTGGAAGTGTAAACC
GAAGTGTAAACACCCCGGGTCCCCTGTTGA|CGCTTACCCACTGGAATATGAGGTCTGACA
GGCATGGTTCCCACAGGTGGAAGTGTAAAC|TGACACCCCCTTAAGTGCTAGTCTTAAAAG
CTGTACCCTATCACCTACCCTTCTTCAGGC|AACCCTTCCCTGCGCCCGCGAAGATGGGGG
TGGTCTCGAGTGTTGACGCCAAAGGCATGG|TTCGCGGGGGCATGGTTCCCACAGGTGGAA
CCACAGGTGGAAGTGTAAACCTCCGGACTC|TAAACCAGCCTCTGCTGAACCAGTGCGAAA
TCGAGTGTTGACGCCAAAGGCATGGTTCCC|GGGGGCATGGTTCCCACAGGTGGAAGTGTA
GTAAACCAGCCTCTGCTGAACCAGTGCGAA|GTAAACATGGTTCCCACAGGTGGAAGTGTA
GGGGGCATGGTTCCCACAGGTGGAAGTGTA|GGCGGCATGGTTCCCACAGGTGGAAGTGTA
ATATGCTCGCAATTTATCTACCAGCACCAT|GAGACGGTAGCGTGAGGGCATGGTTCCCAC
GCATGGTTCCCACAGGTGGAAGTGTAAACA|GGGGATGGCACATCTTTAATTGTTGTGTTT
CCACCCTTGAGCGCTAGTATCAGGATGCTT|TGTAAACAAATGTGGGGAAGAGCGAGAGTG
CATGGTTCCCACAGGTGGAAGTGTAAACTG|GTAAACAGTTCCGATCCAGCTAAGGTCACT
GAGACGGTAGCGTGAGGGCATGGTTCCCAC|ACGGTCCCTCAGGTTCCTTCTCGAGCGTAA
GTTTGGGGATACGACTCGTACCGATTGTTC|GTCCCCTTCGTTCCGCCTTCCATAGGTTCT
CCGGCATGGTTCCCACAGGTGGAAGTGTAA|CCTGACACCCCCTTAAGTGCTAGTCTTAAA
ATCGGGCATGGTTCCCACAGGTGGAAGTGT|GATGCCGACACCCGTCGAATCGTTAAAGAT
TTGATCGGGACCTGGTGGTCTCGAGTGTTG|GAAATCCGCACAGATTTCGCGGGGGCATGG
AATAGGCCACCCTTGAGCGCTAGTATCAGG|TGGAAGTGTAAACAAATGTGGGGAAGAGCG
ACCATAGTACCACACTATAGGAGAAATTTA|CCCACAGGTGGAAGTGTAAACACCCCGGGT
GCGAAGATGGGGGGGATGGCACATCTTTAA|CTGGCATGGTTCCCACAGGTGGAAGTGTAA
CCTCTATATGCTGACTAAAAACTGAATCAG|CTACCACATTCGGAACCACCGGCATGGTTC
GGTGGAAGTGTAAACAGTTCCGATCCAGCT|TTTAATTGTTGTGTTTAACATGTTTGGGGA
CTAGTCTTAAAAGCGGCAAACCTATATCTG|CTTGAGCGCTAGTATCAGGATGCTTATTGA
TGCTGAACCAGTGCGAAACATGGTGGGAGT|CCACAGGTGGAAGTGTAAACTGGACCTCTA
GACTCGTACCGATTGTTCGTCAAGCCCCTG|CCGCCTTCCATAGGTTCTTATGCCAGATAT
CACATCTTCTGTACCCTATCACCTACCCTT|GAAGTGTAAACCCTTCCCTGCGCCCGCGAA
TGTGTTTAACATGTTTGGGGATACGACTCG|ACATTATACACCGTCCCCTTCGTTCCGCCT
AGAAATCCGCACAGATTTCGCGGGGGCATG|CGCGATAAGACACGTGGGCCTGGCGGCATG
ACACCCCCTTAAGTGCTAGTCTTAAAAGCG|GATGAATAGGCCACCCTTGAGCGCTAGTAT
ACTCCCGGCCGTAAACACTGATCTATACGC|GAAACATGGTGGGAGTAAAGAAGGCATGGT
CCGATCCAGCTAAGGTCACTCTCTACCACA|ATGTTTGGGGATACGACTCGTACCGATTGT
TACGACTCGTACCGATTGTTCGTCAAGCCC|GTTCCGCCTTCCATAGGTTCTTATGCCAGA
ACTGGACCTCTATATGCTGACTAAAAACTG|CACTCTCTACCACATTCGGAACCACCGGCA
TCTTTAATTGTTGTGTTTAACATGTTTGGG|AGTGTAAACGAACATTATACACCGTCCCCT
GGCATGGTTCCCACAGGTGGAAGTGTAAAC|GGGGGATGGCACATCTTTAATTGTTGTGTT
TATGCTCGCAATTTATCTACCAGCACCATA|AGACGGTAGCGTGAGGGCATGGTTCCCACA
TGGCGGCATGGTTCCCACAGGTGGAAGTGT|CCTTCTTCAGGCATGGTTCCCACAGGTGGA
CAGGTTCCTTCTCGAGCGTAAAATTACGCT|CCACAGGTGGAAGTGTAAACCGTGTGGAAA
ACACCGTCCCCTTCGTTCCGCCTTCCATAG|TTCCCACAGGTGGAAGTGTAAACAGAACCC
TCGAGCGTAAAATTACGCTTACCCACTGGA|AGTGTAAACCGTGTGGAAAGCGCCGGGCCT
ACCAGCCTCTGCTGAACCAGTGCGAAACAT|ACATGGTTCCCACAGGTGGAAGTGTAAACT
TCGTCAAGCCCCTGACACCCCCTTAAGTGC|CTTATGCCAGATATGATGAATAGGCCACCC
AGGTGGAAGTGTAAACCTCCGGACTCCCGG|CCAGCCTCTGCTGAACCAGTGCGAAACATG
ATGAGGTCTGACAGTATGCATCTGCCTGGG|ATCGGGACCTGGTGGTCTCGAGTGTTGACG
TGGCACATCTTTAATTGTTGTGTTTAACAT|AGGTGGAAGTGTAAACGAACATTATACACC
CACAGGTGGAAGTGTAAACCCTTCCCTGCG|TAAGTGCTAGTCTTAAAAGCGGCAAACCTA
ACGCCAAAGGCATGGTTCCCACAGGTGGAA|TTCCCACAGGTGGAAGTGTAAACCAGCCTC
TGGGGGGGATGGCACATCTTTAATTGTTGT|GGTTCCCACAGGTGGAAGTGTAAACGAACA
ATCCAGCTAAGGTCACTCTCTACCACATTC|TTTGGGGATACGACTCGTACCGATTGTTCG
TCCCTGGGCATGGTTCGGCATGGTTCCCAC|GTTCCCACAGGTGGAAGTGTAAACCTCCGG
ATGAATAGGCCACCCTTGAGCGCTAGTATC|AGGTGGAAGTGTAAACAAATGTGGGGAAGA
GACCTGGTGGTCTCGAGTGTTGACGCCAAA|CACAGATTTCGCGGGGGCATGGTTCCCACA
AGGTGGAAGTGTAAACCCACAGGTGGAAGT|ACTCCCGGCCGTAAACACTGATCTATACGC
CCAGCTAAGGTCACTCTCTACCACATTCGG|TGGGGATACGACTCGTACCGATTGTTCGTC
GGTGGAAGTGTAAACACCCCGGGTCCCCTG|ATTACGCTTACCCACTGGAATATGAGGTCT
GTAAACACCCCGGGTCCCCTGTTGACGGCA|ACCCACTGGAATATGAGGTCTGACAGTATG
CACAGGTGGAAGTGTAAACGAGCGCGATAA|GAATCAGTCATACGGACACATCTTCTGTAC
TTTAATTGTTGTGTTTAACATGTTTGGGGA|TGTAAACGAACATTATACACCGTCCCCTTC
AAGTGTAAACCGTGTGGAAAGCGCCGGGCC|ACGCCCGCTGACTTACGTTGTAGACGCAGA
TATGAGGTCTGACAGTATGCATCTGCCTGG|GATCGGGACCTGGTGGTCTCGAGTGTTGAC
CTATAGGAGAAATTTACTATCCCCGGTTAT|TGTAAACACCCCGGGTCCCCTGTTGACGGC
AGTGTAAACCCTTCCCTGCGCCCGCGAAGA|TCTTAAAAGCGGCAAACCTATATCTGGCAT
TAAACCCTTCCCTGCGCCCGCGAAGATGGG|AAAAGCGGCAAACCTATATCTGGCATGGTT
GGAATAATGTATCGGGCATGGTTCCCACAG|GATCGTCGCTGATGCCGACACCCGTCGAAT
TCGATATGCTCGCAATTTATCTACCAGCAC|ATAGAGACGGTAGCGTGAGGGCATGGTTCC
TTCCCACAGGTGGAAGTGTAAACAGTTCCG|GGCACATCTTTAATTGTTGTGTTTAACATG
AGACGCAGAGAAATCCGCACAGATTTCGCG|TAAACGAGCGCGATAAGACACGTGGGCCTG
CAGGTGGAAGTGTAAACCCTTCCCTGCGCC|AGTGCTAGTCTTAAAAGCGGCAAACCTATA
TGGTTCCCTGGGCATGGTTCGGCATGGTTC|CATGGTTCCCACAGGTGGAAGTGTAAACCT
CGGGGGCATGGTTCCCACAGGTGGAAGTGT|TGGCGGCATGGTTCCCACAGGTGGAAGTGT
TTGAAGCCCGGGACGCACTCCGGAATAATG|GGTCAAGAGGAGGTGTCCTTGGATCGTCGC
GGCATGGTTCCCACAGGTGGAAGTGTAAAC|GGCATGGTTCCCACAGGTGGAAGTGTAAAC
GAAGTGTAAACCAGCCTCTGCTGAACCAGT|GAAGTGTAAACATGGTTCCCACAGGTGGAA
CATGGTTCCCACAGGTGGAAGTGTAAACCT|TGGAAGTGTAAACCAGCCTCTGCTGAACCA
GTCTGGTTCCCTGGGCATGGTTCGGCATGG|AGGCATGGTTCCCACAGGTGGAAGTGTAAA
AGTGTAAACCGTGTGGAAAGCGCCGGGCCT|CGCCCGCTGACTTACGTTGTAGACGCAGAG
GTATGCATCTGCCTGGGCCGCGTCTGGTTC|GGTCTCGAGTGTTGACGCCAAAGGCATGGT
CCCACAGGTGGAAGTGTAAACGAGCGCGAT|CTGAATCAGTCATACGGACACATCTTCTGT
CAGTCATACGGACACATCTTCTGTACCCTA|TTCCCACAGGTGGAAGTGTAAACCCTTCCC
GTGTAAACCCACAGGTGGAAGTGTAAACCG|CCGTAAACACTGATCTATACGCCCGCTGAC
ATAATGTATCGGGCATGGTTCCCACAGGTG|CGTCGCTGATGCCGACACCCGTCGAATCGT
CCACAGGTGGAAGTGTAAACACCCCGGGTC|GTAAAATTACGCTTACCCACTGGAATATGA
CAGATATGATGAATAGGCCACCCTTGAGCG|GTTCCCACAGGTGGAAGTGTAAACAAATGT
AGTGTAAACATGGTTCCCACAGGTGGAAGT|GTGGAAGTGTAAACAGTTCCGATCCAGCTA
AGTGTAAACAAATAGAGACGGTAGCGTGAG|CTACTAACGGTCTAACGGTCCCTCAGGTTC
TCCCGGCCGTAAACACTGATCTATACGCCC|AACATGGTGGGAGTAAAGAAGGCATGGTTC
GTGTAAACAGTTCCGATCCAGCTAAGGTCA|GTTGTGTTTAACATGTTTGGGGATACGACT
CCGGAATAATGTATCGGGCATGGTTCCCAC|TGGATCGTCGCTGATGCCGACACCCGTCGA
GCATGGTTCCCACAGGTGGAAGTGTAAACG|ACTAAAAACTGAATCAGTCATACGGACACA
CCTCCGGACTCCCGGCCGTAAACACTGATC|CCAGTGCGAAACATGGTGGGAGTAAAGAAG
TAAACACCCCGGGTCCCCTGTTGACGGCAC|CCCACTGGAATATGAGGTCTGACAGTATGC
AAACTGAATCAGTCATACGGACACATCTTC|CCGGCATGGTTCCCACAGGTGGAAGTGTAA
CTGGCGGCATGGTTCCCACAGGTGGAAGTG|CCCTTCTTCAGGCATGGTTCCCACAGGTGG
ACGACTCGTACCGATTGTTCGTCAAGCCCC|TTCCGCCTTCCATAGGTTCTTATGCCAGAT
TCAGGCATGGTTCCCACAGGTGGAAGTGTA|TGGGGGGGATGGCACATCTTTAATTGTTGT
CGATCCAGCTAAGGTCACTCTCTACCACAT|TGTTTGGGGATACGACTCGTACCGATTGTT
AAGGCATGGTTCCCACAGGTGGAAGTGTAA|CAGGTGGAAGTGTAAACCAGCCTCTGCTGA
GGTTATCAGAGCGCCATGTCTATGACATTC|GACGGCACACAGCGATCTCCTCGCGGCATG
TTATTGAAGCCCGGGACGCACTCCGGAATA|TGCGGTCAAGAGGAGGTGTCCTTGGATCGT
CGCTAGTATCAGGATGCTTATTGAAGCCCG|GTGGGGAAGAGCGAGAGTGCGGTCAAGAGG
CCGGGACGCACTCCGGAATAATGTATCGGG|AGGAGGTGTCCTTGGATCGTCGCTGATGCC
CCGCTGACTTACGTTGTAGACGCAGAGAAA|TCCCACAGGTGGAAGTGTAAACGAGCGCGA
GCATGGTTCCCACAGGTGGAAGTGTAAACC|TGTAAACCTCCGGACTCCCGGCCGTAAACA
GGCCGTAAACACTGATCTATACGCCCGCTG|TGGTGGGAGTAAAGAAGGCATGGTTCCCAC
GTGCTAGTCTTAAAAGCGGCAAACCTATAT|ACCCTTGAGCGCTAGTATCAGGATGCTTAT
GCAAACCTATATCTGGCATGGTTCCCACAG|CAGGATGCTTATTGAAGCCCGGGACGCACT
GAAGTGTAAACTGGACCTCTATATGCTGAC|AGCTAAGGTCACTCTCTACCACATTCGGAA
CCGATTGTTCGTCAAGCCCCTGACACCCCC|CATAGGTTCTTATGCCAGATATGATGAATA
GGTTCTTATGCCAGATATGATGAATAGGCC|CTAAGGGCATGGTTCCCACAGGTGGAAGTG
GCGCGATAAGACACGTGGGCCTGGCGGCAT|CTTCTGTACCCTATCACCTACCCTTCTTCA
TCCCCGGTTATCAGAGCGCCATGTCTATGA|CTGTTGACGGCACACAGCGATCTCCTCGCG
ACACATCTTCTGTACCCTATCACCTACCCT|GGAAGTGTAAACCCTTCCCTGCGCCCGCGA
TTCCCACAGGTGGAAGTGTAAACGAGCGCG|AACTGAATCAGTCATACGGACACATCTTCT
TGGTTCCCACAGGTGGAAGTGTAAACCTCC|GAAGTGTAAACCAGCCTCTGCTGAACCAGT
TGGTTCCCACAGGTGGAAGTGTAAACGAGC|AAAAACTGAATCAGTCATACGGACACATCT
GTGTAAACACCCCGGGTCCCCTGTTGACGG|TTACCCACTGGAATATGAGGTCTGACAGTA
AACCCTTCCCTGCGCCCGCGAAGATGGGGG|AAGCGGCAAACCTATATCTGGCATGGTTCC
GTAAAGAAGGCATGGTTCCCACAGGTGGAA|TATATGCTGACTAAAAACTGAATCAGTCAT
AAAGCGGCAAACCTATATCTGGCATGGTTC|TAGTATCAGGATGCTTATTGAAGCCCGGGA
ACAGGTGGAAGTGTAAACCTCCGGACTCCC|AACCAGCCTCTGCTGAACCAGTGCGAAACA
GTAAACATGGTTCCCACAGGTGGAAGTGTA|GAAGTGTAAACAGTTCCGATCCAGCTAAGG
ACGCACTCCGGAATAATGTATCGGGCATGG|GTGTCCTTGGATCGTCGCTGATGCCGACAC
TAGGAGAAATTTACTATCCCCGGTTATCAG|AAACACCCCGGGTCCCCTGTTGACGGCACA
AGAGACGGTAGCGTGAGGGCATGGTTCCCA|AACGGTCCCTCAGGTTCCTTCTCGAGCGTA
AACGAGCGCGATAAGACACGTGGGCCTGGC|CACATCTTCTGTACCCTATCACCTACCCTT
CCTATCACCTACCCTTCTTCAGGCATGGTT|TCCCTGCGCCCGCGAAGATGGGGGGGATGG
ACCCTTCTTCAGGCATGGTTCCCACAGGTG|CGCGAAGATGGGGGGGATGGCACATCTTTA
AAGTGTAAACCAGCCTCTGCTGAACCAGTG|AAGTGTAAACATGGTTCCCACAGGTGGAAG
GTTCGGCATGGTTCCCACAGGTGGAAGTGT|GGAAGTGTAAACCTCCGGACTCCCGGCCGT
GTAAACCCACAGGTGGAAGTGTAAACCGTG|GTAAACACTGATCTATACGCCCGCTGACTT
AGGTGGAAGTGTAAACTGGACCTCTATATG|GATCCAGCTAAGGTCACTCTCTACCACATT
GTGGAAGTGTAAACCGTGTGGAAAGCGCCG|CTATACGCCCGCTGACTTACGTTGTAGACG
CGATATGCTCGCAATTTATCTACCAGCACC|TAGAGACGGTAGCGTGAGGGCATGGTTCCC
GCACCATAGTACCACACTATAGGAGAAATT|TTCCCACAGGTGGAAGTGTAAACACCCCGG
ACGGACACATCTTCTGTACCCTATCACCTA|AGGTGGAAGTGTAAACCCTTCCCTGCGCCC
TCCCACAGGTGGAAGTGTAAACGAACATTA|GACGCACTCCGGAATAATGTATCGGGCATG
TCGGCATGGTTCCCACAGGTGGAAGTGTAA|AAGTGTAAACCTCCGGACTCCCGGCCGTAA
ACATGGTGGGAGTAAAGAAGGCATGGTTCC|AACTGGACCTCTATATGCTGACTAAAAACT
GCAATTTATCTACCAGCACCATAGTACCAC|AGCGTGAGGGCATGGTTCCCACAGGTGGAA
GGTTCCCACAGGTGGAAGTGTAAACAGTTC|ATGGCACATCTTTAATTGTTGTGTTTAACA
GGATACGACTCGTACCGATTGTTCGTCAAG|TTCGTTCCGCCTTCCATAGGTTCTTATGCC
TTCCCACAGGTGGAAGTGTAAACTGGACCT|CAGTTCCGATCCAGCTAAGGTCACTCTCTA
CCTGACACCCCCTTAAGTGCTAGTCTTAAA|ATATGATGAATAGGCCACCCTTGAGCGCTA
GTAAACTACTAACGGTCTAACGGTCCCTCA|CATGGTTCCCACAGGTGGAAGTGTAAACCC
CGCGGGGGCATGGTTCCCACAGGTGGAAGT|CCTGGCGGCATGGTTCCCACAGGTGGAAGT
GGCATGGTTCCCACAGGTGGAAGTGTAAAC|CTTCTCGAGCGTAAAATTACGCTTACCCAC
TGGAAGTGTAAACATGGTTCCCACAGGTGG|ACAGGTGGAAGTGTAAACAGTTCCGATCCA
CCGTCCCCTTCGTTCCGCCTTCCATAGGTT|CCACAGGTGGAAGTGTAAACAGAACCCTAA
AATGTATCGGGCATGGTTCCCACAGGTGGA|TCGCTGATGCCGACACCCGTCGAATCGTTA
AGAGCGCCATGTCTATGACATTCCAGGCAT|CACAGCGATCTCCTCGCGGCATGGTTCCCA
TGAATCAGTCATACGGACACATCTTCTGTA|CATGGTTCCCACAGGTGGAAGTGTAAACCC
TCGCGGCATGGTTCCCACAGGTGGAAGTGT|CGCGTCTGGTTCCCTGGGCATGGTTCGGCA
CGCAATTTATCTACCAGCACCATAGTACCA|TAGCGTGAGGGCATGGTTCCCACAGGTGGA
TAATGTATCGGGCATGGTTCCCACAGGTGG|GTCGCTGATGCCGACACCCGTCGAATCGTT
AATTGTTGTGTTTAACATGTTTGGGGATAC|AAACGAACATTATACACCGTCCCCTTCGTT
ACACTGATCTATACGCCCGCTGACTTACGT|GTAAAGAAGGCATGGTTCCCACAGGTGGAA
CGGGCCTTGATCGGGACCTGGTGGTCTCGA|CGCAGAGAAATCCGCACAGATTTCGCGGGG
AAACCTCCGGACTCCCGGCCGTAAACACTG|GAACCAGTGCGAAACATGGTGGGAGTAAAG
CTTAAAAGCGGCAAACCTATATCTGGCATG|GCGCTAGTATCAGGATGCTTATTGAAGCCC
ATCTGGCATGGTTCCCACAGGTGGAAGTGT|ATTGAAGCCCGGGACGCACTCCGGAATAAT
TTTGGGGATACGACTCGTACCGATTGTTCG|TCCCCTTCGTTCCGCCTTCCATAGGTTCTT
GTTCCCACAGGTGGAAGTGTAAACCCTTCC|CCCCTTAAGTGCTAGTCTTAAAAGCGGCAA
AGTGTAAACGAACATTATACACCGTCCCCT|ATAATGTATCGGGCATGGTTCCCACAGGTG
ATCTGCCTGGGCCGCGTCTGGTTCCCTGGG|GAGTGTTGACGCCAAAGGCATGGTTCCCAC
TGCTCGCAATTTATCTACCAGCACCATAGT|ACGGTAGCGTGAGGGCATGGTTCCCACAGG
CGGCATGGTTCCCACAGGTGGAAGTGTAAA|GTCTGGTTCCCTGGGCATGGTTCGGCATGG
GTGTAAACAAATAGAGACGGTAGCGTGAGG|TACTAACGGTCTAACGGTCCCTCAGGTTCC
GGCATGGTTCCCACAGGTGGAAGTGTAAAC|CCGACACCCGTCGAATCGTTAAAGATCAGG
CTATCCCCGGTTATCAGAGCGCCATGTCTA|CCCCTGTTGACGGCACACAGCGATCTCCTC
TTCTCGAGCGTAAAATTACGCTTACCCACT|GGAAGTGTAAACCGTGTGGAAAGCGCCGGG
CAGGTGGAAGTGTAAACTACTAACGGTCTA|GCATGGTTCGGCATGGTTCCCACAGGTGGA
TGATCTATACGCCCGCTGACTTACGTTGTA|AGAAGGCATGGTTCCCACAGGTGGAAGTGT
CGAGCGTAAAATTACGCTTACCCACTGGAA|GTGTAAACCGTGTGGAAAGCGCCGGGCCTT
GCCTGGGCCGCGTCTGGTTCCCTGGGCATG|GTTGACGCCAAAGGCATGGTTCCCACAGGT
GTCTATGACATTCCAGGCATGGTTCCCACA|TCCTCGCGGCATGGTTCCCACAGGTGGAAG
TGTAAACCGTGTGGAAAGCGCCGGGCCTTG|CCCGCTGACTTACGTTGTAGACGCAGAGAA
GTGGAAGTGTAAACACCCCGGGTCCCCTGT|TTACGCTTACCCACTGGAATATGAGGTCTG
AACGGTCTAACGGTCCCTCAGGTTCCTTCT|ACAGGTGGAAGTGTAAACCCACAGGTGGAA
GTCCCCTTCGTTCCGCCTTCCATAGGTTCT|ACAGGTGGAAGTGTAAACAGAACCCTAAGG
TATCTGGCATGGTTCCCACAGGTGGAAGTG|TATTGAAGCCCGGGACGCACTCCGGAATAA
TTGACGCCAAAGGCATGGTTCCCACAGGTG|TGGTTCCCACAGGTGGAAGTGTAAACCAGC
GGGACGCACTCCGGAATAATGTATCGGGCA|GAGGTGTCCTTGGATCGTCGCTGATGCCGA
TCTATATGCTGACTAAAAACTGAATCAGTC|ACCACATTCGGAACCACCGGCATGGTTCCC
CACTATAGGAGAAATTTACTATCCCCGGTT|AGTGTAAACACCCCGGGTCCCCTGTTGACG
CCGGACTCCCGGCCGTAAACACTGATCTAT|GTGCGAAACATGGTGGGAGTAAAGAAGGCA
GACAGTATGCATCTGCCTGGGCCGCGTCTG|TGGTGGTCTCGAGTGTTGACGCCAAAGGCA
CCAGCACCATAGTACCACACTATAGGAGAA|TGGTTCCCACAGGTGGAAGTGTAAACACCC
TTCGCGGGGGCATGGTTCCCACAGGTGGAA|GGCCTGGCGGCATGGTTCCCACAGGTGGAA
GGTGGGAGTAAAGAAGGCATGGTTCCCACA|GGACCTCTATATGCTGACTAAAAACTGAAT
CATGGTTCCCACAGGTGGAAGTGTAAACAC|TCTCGAGCGTAAAATTACGCTTACCCACTG
CACACTATAGGAGAAATTTACTATCCCCGG|GAAGTGTAAACACCCCGGGTCCCCTGTTGA
CACTGGAATATGAGGTCTGACAGTATGCAT|CGGGCCTTGATCGGGACCTGGTGGTCTCGA
AACATGTTTGGGGATACGACTCGTACCGAT|ACACCGTCCCCTTCGTTCCGCCTTCCATAG
GAGTGTTGACGCCAAAGGCATGGTTCCCAC|GGGCATGGTTCCCACAGGTGGAAGTGTAAA
GGTCTCGAGTGTTGACGCCAAAGGCATGGT|TCGCGGGGGCATGGTTCCCACAGGTGGAAG
CCACAGGTGGAAGTGTAAACAAATAGAGAC|GGAAGTGTAAACTACTAACGGTCTAACGGT
GACGCACTCCGGAATAATGTATCGGGCATG|GGTGTCCTTGGATCGTCGCTGATGCCGACA
CAGGTGGAAGTGTAAACCCACAGGTGGAAG|GACTCCCGGCCGTAAACACTGATCTATACG
CCCTGGGCATGGTTCGGCATGGTTCCCACA|TTCCCACAGGTGGAAGTGTAAACCTCCGGA
CATAGGTTCTTATGCCAGATATGATGAATA|AACCCTAAGGGCATGGTTCCCACAGGTGGA
TTTATCTACCAGCACCATAGTACCACACTA|TGAGGGCATGGTTCCCACAGGTGGAAGTGT
CTATACGCCCGCTGACTTACGTTGTAGACG|GGCATGGTTCCCACAGGTGGAAGTGTAAAC
ATGGTTCCCACAGGTGGAAGTGTAAACCTC|GGAAGTGTAAACCAGCCTCTGCTGAACCAG
AACAAATAGAGACGGTAGCGTGAGGGCATG|ACGGTCTAACGGTCCCTCAGGTTCCTTCTC
AGTGTAAACCCACAGGTGGAAGTGTAAACC|GCCGTAAACACTGATCTATACGCCCGCTGA
CGGCATGGTTCCCACAGGTGGAAGTGTAAA|AGTGTAAACCTCCGGACTCCCGGCCGTAAA
ACTCGATATGCTCGCAATTTATCTACCAGC|AAATAGAGACGGTAGCGTGAGGGCATGGTT
CACTCTCTACCACATTCGGAACCACCGGCA|CTCGTACCGATTGTTCGTCAAGCCCCTGAC
ACAGGTGGAAGTGTAAACTGGACCTCTATA|CCGATCCAGCTAAGGTCACTCTCTACCACA
CCATGTCTATGACATTCCAGGCATGGTTCC|GATCTCCTCGCGGCATGGTTCCCACAGGTG
AAACCCACAGGTGGAAGTGTAAACCGTGTG|AAACACTGATCTATACGCCCGCTGACTTAC
TCTACCACATTCGGAACCACCGGCATGGTT|ACCGATTGTTCGTCAAGCCCCTGACACCCC
GCATGGTTCCCACAGGTGGAAGTGTAAACC|GCATGGTTCCCACAGGTGGAAGTGTAAACA
AACACCCCGGGTCCCCTGTTGACGGCACAC|CACTGGAATATGAGGTCTGACAGTATGCAT
GTCCCCTGTTGACGGCACACAGCGATCTCC|TGAGGTCTGACAGTATGCATCTGCCTGGGC
AAACACCCCGGGTCCCCTGTTGACGGCACA|CCACTGGAATATGAGGTCTGACAGTATGCA
ACCTGGTGGTCTCGAGTGTTGACGCCAAAG|ACAGATTTCGCGGGGGCATGGTTCCCACAG
ATGCTTATTGAAGCCCGGGACGCACTCCGG|AGAGTGCGGTCAAGAGGAGGTGTCCTTGGA
TGGAAAGCGCCGGGCCTTGATCGGGACCTG|ACGTTGTAGACGCAGAGAAATCCGCACAGA
GGTGGAAGTGTAAACGAACATTATACACCG|TCCGGAATAATGTATCGGGCATGGTTCCCA
ACCGTGTGGAAAGCGCCGGGCCTTGATCGG|TGACTTACGTTGTAGACGCAGAGAAATCCG
CTTACGTTGTAGACGCAGAGAAATCCGCAC|GGTGGAAGTGTAAACGAGCGCGATAAGACA
CCGCGAAGATGGGGGGGATGGCACATCTTT|ATCTGGCATGGTTCCCACAGGTGGAAGTGT
ATCTCCTCGCGGCATGGTTCCCACAGGTGG|CTGGGCCGCGTCTGGTTCCCTGGGCATGGT
CAGTTCCGATCCAGCTAAGGTCACTCTCTA|TTAACATGTTTGGGGATACGACTCGTACCG
GCCTGGCGGCATGGTTCCCACAGGTGGAAG|TACCCTTCTTCAGGCATGGTTCCCACAGGT
CGAAGATGGGGGGGATGGCACATCTTTAAT|TGGCATGGTTCCCACAGGTGGAAGTGTAAA
TGGAAGTGTAAACACCCCGGGTCCCCTGTT|TACGCTTACCCACTGGAATATGAGGTCTGA
ACCACCGGCATGGTTCCCACAGGTGGAAGT|AGCCCCTGACACCCCCTTAAGTGCTAGTCT
TCGTACCGATTGTTCGTCAAGCCCCTGACA|CCTTCCATAGGTTCTTATGCCAGATATGAT
GTGTAAACCGTGTGGAAAGCGCCGGGCCTT|GCCCGCTGACTTACGTTGTAGACGCAGAGA
CTGACTTACGTTGTAGACGCAGAGAAATCC|CACAGGTGGAAGTGTAAACGAGCGCGATAA
TCTTATGCCAGATATGATGAATAGGCCACC|AGGGCATGGTTCCCACAGGTGGAAGTGTAA
GTGTAAACGAGCGCGATAAGACACGTGGGC|ACGGACACATCTTCTGTACCCTATCACCTA
CTGATCTATACGCCCGCTGACTTACGTTGT|AAGAAGGCATGGTTCCCACAGGTGGAAGTG
CCTCGCGGCATGGTTCCCACAGGTGGAAGT|GCCGCGTCTGGTTCCCTGGGCATGGTTCGG
AAAGGCATGGTTCCCACAGGTGGAAGTGTA|ACAGGTGGAAGTGTAAACCAGCCTCTGCTG
TCGGGCATGGTTCCCACAGGTGGAAGTGTA|ATGCCGACACCCGTCGAATCGTTAAAGATC
CATGGTTCGGCATGGTTCCCACAGGTGGAA|AGGTGGAAGTGTAAACCTCCGGACTCCCGG
ATGGTTCCCACAGGTGGAAGTGTAAACACC|CTCGAGCGTAAAATTACGCTTACCCACTGG
GACCTCTATATGCTGACTAAAAACTGAATC|CTCTACCACATTCGGAACCACCGGCATGGT
ACGGTCTAACGGTCCCTCAGGTTCCTTCTC|CAGGTGGAAGTGTAAACCCACAGGTGGAAG
CACCCCCTTAAGTGCTAGTCTTAAAAGCGG|ATGAATAGGCCACCCTTGAGCGCTAGTATC
CCACCGGCATGGTTCCCACAGGTGGAAGTG|GCCCCTGACACCCCCTTAAGTGCTAGTCTT
TACGGACACATCTTCTGTACCCTATCACCT|CAGGTGGAAGTGTAAACCCTTCCCTGCGCC
TAAACAGTTCCGATCCAGCTAAGGTCACTC|GTGTTTAACATGTTTGGGGATACGACTCGT
ATAAGACACGTGGGCCTGGCGGCATGGTTC|GTACCCTATCACCTACCCTTCTTCAGGCAT
ACCTATATCTGGCATGGTTCCCACAGGTGG|ATGCTTATTGAAGCCCGGGACGCACTCCGG
AAACCAGCCTCTGCTGAACCAGTGCGAAAC|AAACATGGTTCCCACAGGTGGAAGTGTAAA
CCACAGGTGGAAGTGTAAACCAGCCTCTGC|CCACAGGTGGAAGTGTAAACATGGTTCCCA
AGTGTAAACCTCCGGACTCCCGGCCGTAAA|CTGCTGAACCAGTGCGAAACATGGTGGGAG
CGGTTATCAGAGCGCCATGTCTATGACATT|TGACGGCACACAGCGATCTCCTCGCGGCAT
TATCACCTACCCTTCTTCAGGCATGGTTCC|CCTGCGCCCGCGAAGATGGGGGGGATGGCA
TCAGAGCGCCATGTCTATGACATTCCAGGC|CACACAGCGATCTCCTCGCGGCATGGTTCC
CGGACTCCCGGCCGTAAACACTGATCTATA|TGCGAAACATGGTGGGAGTAAAGAAGGCAT
TTGTTCGTCAAGCCCCTGACACCCCCTTAA|GGTTCTTATGCCAGATATGATGAATAGGCC
TGAAGCCCGGGACGCACTCCGGAATAATGT|GTCAAGAGGAGGTGTCCTTGGATCGTCGCT
CGATCTCCTCGCGGCATGGTTCCCACAGGT|GCCTGGGCCGCGTCTGGTTCCCTGGGCATG
ATGGTTCCCACAGGTGGAAGTGTAAACGAG|TAAAAACTGAATCAGTCATACGGACACATC
CAGGTGGAAGTGTAAACTGGACCTCTATAT|CGATCCAGCTAAGGTCACTCTCTACCACAT
CTCCCGGCCGTAAACACTGATCTATACGCC|AAACATGGTGGGAGTAAAGAAGGCATGGTT
AACGGTCCCTCAGGTTCCTTCTCGAGCGTA|AAGTGTAAACCCACAGGTGGAAGTGTAAAC
CCCACTGGAATATGAGGTCTGACAGTATGC|GCCGGGCCTTGATCGGGACCTGGTGGTCTC
CAAACCTATATCTGGCATGGTTCCCACAGG|AGGATGCTTATTGAAGCCCGGGACGCACTC
AACCACCGGCATGGTTCCCACAGGTGGAAG|AAGCCCCTGACACCCCCTTAAGTGCTAGTC
TTTAACATGTTTGGGGATACGACTCGTACC|TATACACCGTCCCCTTCGTTCCGCCTTCCA
TTGGGGATACGACTCGTACCGATTGTTCGT|CCCCTTCGTTCCGCCTTCCATAGGTTCTTA
AGTGTAAACCAGCCTCTGCTGAACCAGTGC|AGTGTAAACATGGTTCCCACAGGTGGAAGT
TCAGTCATACGGACACATCTTCTGTACCCT|GTTCCCACAGGTGGAAGTGTAAACCCTTCC
GTTCCGCCTTCCATAGGTTCTTATGCCAGA|AGTGTAAACAGAACCCTAAGGGCATGGTTC
CTCTCTACCACATTCGGAACCACCGGCATG|CGTACCGATTGTTCGTCAAGCCCCTGACAC
GGTTCCCACAGGTGGAAGTGTAAACAGAAC|ACCCGTCGAATCGTTAAAGATCAGGCCTCA
GTCTCGAGTGTTGACGCCAAAGGCATGGTT|CGCGGGGGCATGGTTCCCACAGGTGGAAGT
TGCGCCCGCGAAGATGGGGGGGATGGCACA|CCTATATCTGGCATGGTTCCCACAGGTGGA
ATATGCTGACTAAAAACTGAATCAGTCATA|ACATTCGGAACCACCGGCATGGTTCCCACA
AACTACTAACGGTCTAACGGTCCCTCAGGT|GGTTCCCACAGGTGGAAGTGTAAACCCACA
AAACTGGACCTCTATATGCTGACTAAAAAC|GTCACTCTCTACCACATTCGGAACCACCGG
TAGCGTGAGGGCATGGTTCCCACAGGTGGA|CTCAGGTTCCTTCTCGAGCGTAAAATTACG
ATGGTTCCCACAGGTGGAAGTGTAAACTAC|GGTTCCCTGGGCATGGTTCGGCATGGTTCC
TCCCACAGGTGGAAGTGTAAACCAGCCTCT|TCCCACAGGTGGAAGTGTAAACATGGTTCC
ACGAGCGCGATAAGACACGTGGGCCTGGCG|ACATCTTCTGTACCCTATCACCTACCCTTC
CGGAACCACCGGCATGGTTCCCACAGGTGG|GTCAAGCCCCTGACACCCCCTTAAGTGCTA
ATGTTTGGGGATACGACTCGTACCGATTGT|CCGTCCCCTTCGTTCCGCCTTCCATAGGTT
GTGGAAGTGTAAACAGTTCCGATCCAGCTA|TTAATTGTTGTGTTTAACATGTTTGGGGAT
CCCGGTTATCAGAGCGCCATGTCTATGACA|GTTGACGGCACACAGCGATCTCCTCGCGGC
GACACGTGGGCCTGGCGGCATGGTTCCCAC|CCTATCACCTACCCTTCTTCAGGCATGGTT
TTCCGCCTTCCATAGGTTCTTATGCCAGAT|GTGTAAACAGAACCCTAAGGGCATGGTTCC
ACAGGTGGAAGTGTAAACGAGCGCGATAAG|AATCAGTCATACGGACACATCTTCTGTACC
GTTGACGCCAAAGGCATGGTTCCCACAGGT|ATGGTTCCCACAGGTGGAAGTGTAAACCAG
CCTTCCCTGCGCCCGCGAAGATGGGGGGGA|CGGCAAACCTATATCTGGCATGGTTCCCAC
AATAGAGACGGTAGCGTGAGGGCATGGTTC|TCTAACGGTCCCTCAGGTTCCTTCTCGAGC
GCATGGTTCCCACAGGTGGAAGTGTAAACA|TTCAGGCATGGTTCCCACAGGTGGAAGTGT
CCGGTTATCAGAGCGCCATGTCTATGACAT|TTGACGGCACACAGCGATCTCCTCGCGGCA
TAACATGTTTGGGGATACGACTCGTACCGA|TACACCGTCCCCTTCGTTCCGCCTTCCATA
TTGACGGCACACAGCGATCTCCTCGCGGCA|GACAGTATGCATCTGCCTGGGCCGCGTCTG
TGGAAGTGTAAACTACTAACGGTCTAACGG|GGTTCGGCATGGTTCCCACAGGTGGAAGTG
CACTGATCTATACGCCCGCTGACTTACGTT|TAAAGAAGGCATGGTTCCCACAGGTGGAAG
GACGCAGAGAAATCCGCACAGATTTCGCGG|AAACGAGCGCGATAAGACACGTGGGCCTGG
TGGTGGGAGTAAAGAAGGCATGGTTCCCAC|TGGACCTCTATATGCTGACTAAAAACTGAA
CATGTTTGGGGATACGACTCGTACCGATTG|ACCGTCCCCTTCGTTCCGCCTTCCATAGGT
CTACTAACGGTCTAACGGTCCCTCAGGTTC|TTCCCACAGGTGGAAGTGTAAACCCACAGG
GCGCCATGTCTATGACATTCCAGGCATGGT|AGCGATCTCCTCGCGGCATGGTTCCCACAG
TAAACGAGCGCGATAAGACACGTGGGCCTG|GACACATCTTCTGTACCCTATCACCTACCC
CACAGGTGGAAGTGTAAACATGGTTCCCAC|GTTCCCACAGGTGGAAGTGTAAACAGTTCC
CTACCACATTCGGAACCACCGGCATGGTTC|CCGATTGTTCGTCAAGCCCCTGACACCCCC
TGCCAGATATGATGAATAGGCCACCCTTGA|ATGGTTCCCACAGGTGGAAGTGTAAACAAA
TAAACGAACATTATACACCGTCCCCTTCGT|TGTATCGGGCATGGTTCCCACAGGTGGAAG
AAGCCCGGGACGCACTCCGGAATAATGTAT|CAAGAGGAGGTGTCCTTGGATCGTCGCTGA
TCCTCGCGGCATGGTTCCCACAGGTGGAAG|GGCCGCGTCTGGTTCCCTGGGCATGGTTCG
CACGTGGGCCTGGCGGCATGGTTCCCACAG|TATCACCTACCCTTCTTCAGGCATGGTTCC
GGCCTGGCGGCATGGTTCCCACAGGTGGAA|CTACCCTTCTTCAGGCATGGTTCCCACAGG
GGGCATGGTTCCCACAGGTGGAAGTGTAAA|GCCGACACCCGTCGAATCGTTAAAGATCAG
ACAGTTCCGATCCAGCTAAGGTCACTCTCT|TTTAACATGTTTGGGGATACGACTCGTACC
CGGCATGGTTCCCACAGGTGGAAGTGTAAA|CTGACACCCCCTTAAGTGCTAGTCTTAAAA
GCATGGTTCCCACAGGTGGAAGTGTAAACT|CTGGTTCCCTGGGCATGGTTCGGCATGGTT
GGCATGGTTCCCACAGGTGGAAGTGTAAAC|GTGTAAACCTCCGGACTCCCGGCCGTAAAC
GTGGAAGTGTAAACCAGCCTCTGCTGAACC|GTGGAAGTGTAAACATGGTTCCCACAGGTG
CTTCTGTACCCTATCACCTACCCTTCTTCA|GTAAACCCTTCCCTGCGCCCGCGAAGATGG
AGTGTAAACACCCCGGGTCCCCTGTTGACG|CTTACCCACTGGAATATGAGGTCTGACAGT
TCGTTCCGCCTTCCATAGGTTCTTATGCCA|GAAGTGTAAACAGAACCCTAAGGGCATGGT
AGCTAAGGTCACTCTCTACCACATTCGGAA|GGGATACGACTCGTACCGATTGTTCGTCAA
AGACGGTAGCGTGAGGGCATGGTTCCCACA|CGGTCCCTCAGGTTCCTTCTCGAGCGTAAA
GGCCTTGATCGGGACCTGGTGGTCTCGAGT|CAGAGAAATCCGCACAGATTTCGCGGGGGC
TCTAACGGTCCCTCAGGTTCCTTCTCGAGC|TGGAAGTGTAAACCCACAGGTGGAAGTGTA
CCCACAGGTGGAAGTGTAAACCAGCCTCTG|CCCACAGGTGGAAGTGTAAACATGGTTCCC
CGATAAGACACGTGGGCCTGGCGGCATGGT|CTGTACCCTATCACCTACCCTTCTTCAGGC
CGGGACCTGGTGGTCTCGAGTGTTGACGCC|CCGCACAGATTTCGCGGGGGCATGGTTCCC
ATTTACTATCCCCGGTTATCAGAGCGCCAT|CGGGTCCCCTGTTGACGGCACACAGCGATC
GGGCCTGGCGGCATGGTTCCCACAGGTGGA|CCTACCCTTCTTCAGGCATGGTTCCCACAG
GGCCGCGTCTGGTTCCCTGGGCATGGTTCG|CGCCAAAGGCATGGTTCCCACAGGTGGAAG
AGAGAAATCCGCACAGATTTCGCGGGGGCA|AGCGCGATAAGACACGTGGGCCTGGCGGCA
GGTGGAAGTGTAAACCAGCCTCTGCTGAAC|GGTGGAAGTGTAAACATGGTTCCCACAGGT
TACGTTGTAGACGCAGAGAAATCCGCACAG|TGGAAGTGTAAACGAGCGCGATAAGACACG
GTTCCCACAGGTGGAAGTGTAAACAGTTCC|TGGCACATCTTTAATTGTTGTGTTTAACAT
GGCATGGTTCCCACAGGTGGAAGTGTAAAC|GGTGGAAGTGTAAACCAGCCTCTGCTGAAC
ATGACATTCCAGGCATGGTTCCCACAGGTG|CGCGGCATGGTTCCCACAGGTGGAAGTGTA
AGGTGGAAGTGTAAACCGTGTGGAAAGCGC|ATCTATACGCCCGCTGACTTACGTTGTAGA
TGTAAACACCCCGGGTCCCCTGTTGACGGC|TACCCACTGGAATATGAGGTCTGACAGTAT
GCACAGATTTCGCGGGGGCATGGTTCCCAC|GACACGTGGGCCTGGCGGCATGGTTCCCAC
CTATATCTGGCATGGTTCCCACAGGTGGAA|GCTTATTGAAGCCCGGGACGCACTCCGGAA
CCTGGGCATGGTTCGGCATGGTTCCCACAG|TCCCACAGGTGGAAGTGTAAACCTCCGGAC
TCGCAATTTATCTACCAGCACCATAGTACC|GTAGCGTGAGGGCATGGTTCCCACAGGTGG
GAATATGAGGTCTGACAGTATGCATCTGCC|CTTGATCGGGACCTGGTGGTCTCGAGTGTT
CGGGACGCACTCCGGAATAATGTATCGGGC|GGAGGTGTCCTTGGATCGTCGCTGATGCCG
GGATGGCACATCTTTAATTGTTGTGTTTAA|CACAGGTGGAAGTGTAAACGAACATTATAC
GGGCATGGTTCCCACAGGTGGAAGTGTAAA|CCTTCTCGAGCGTAAAATTACGCTTACCCA
AAACACTGATCTATACGCCCGCTGACTTAC|GAGTAAAGAAGGCATGGTTCCCACAGGTGG
TATCTACCAGCACCATAGTACCACACTATA|AGGGCATGGTTCCCACAGGTGGAAGTGTAA
GTCATACGGACACATCTTCTGTACCCTATC|CCCACAGGTGGAAGTGTAAACCCTTCCCTG
GGGAGTAAAGAAGGCATGGTTCCCACAGGT|CCTCTATATGCTGACTAAAAACTGAATCAG
AAGTGTAAACAGTTCCGATCCAGCTAAGGT|TTGTTGTGTTTAACATGTTTGGGGATACGA
CTGGAATATGAGGTCTGACAGTATGCATCT|GGCCTTGATCGGGACCTGGTGGTCTCGAGT
AGGTCACTCTCTACCACATTCGGAACCACC|ACGACTCGTACCGATTGTTCGTCAAGCCCC
CCCCTGTTGACGGCACACAGCGATCTCCTC|AGGTCTGACAGTATGCATCTGCCTGGGCCG
CCGTGTGGAAAGCGCCGGGCCTTGATCGGG|GACTTACGTTGTAGACGCAGAGAAATCCGC
CACACAGCGATCTCCTCGCGGCATGGTTCC|TGCATCTGCCTGGGCCGCGTCTGGTTCCCT
CGCCCGCTGACTTACGTTGTAGACGCAGAG|GGTTCCCACAGGTGGAAGTGTAAACGAGCG
AGCGGCAAACCTATATCTGGCATGGTTCCC|GTATCAGGATGCTTATTGAAGCCCGGGACG
ATACGACTCGTACCGATTGTTCGTCAAGCC|CGTTCCGCCTTCCATAGGTTCTTATGCCAG
TACGCCCGCTGACTTACGTTGTAGACGCAG|ATGGTTCCCACAGGTGGAAGTGTAAACGAG
ATCTTTAATTGTTGTGTTTAACATGTTTGG|AAGTGTAAACGAACATTATACACCGTCCCC
CCCTTCGTTCCGCCTTCCATAGGTTCTTAT|GGTGGAAGTGTAAACAGAACCCTAAGGGCA
GTGGAAGTGTAAACAAATAGAGACGGTAGC|GTAAACTACTAACGGTCTAACGGTCCCTCA
CTATCACCTACCCTTCTTCAGGCATGGTTC|CCCTGCGCCCGCGAAGATGGGGGGGATGGC
GAAGTGTAAACTACTAACGGTCTAACGGTC|TTCGGCATGGTTCCCACAGGTGGAAGTGTA
TCCCACAGGTGGAAGTGTAAACAGTTCCGA|GCACATCTTTAATTGTTGTGTTTAACATGT
GGGCATGGTTCCCACAGGTGGAAGTGTAAA|CGGCATGGTTCCCACAGGTGGAAGTGTAAA
CCGCGTCTGGTTCCCTGGGCATGGTTCGGC|CCAAAGGCATGGTTCCCACAGGTGGAAGTG
TAAACACTGATCTATACGCCCGCTGACTTA|GGAGTAAAGAAGGCATGGTTCCCACAGGTG
GAGAAATCCGCACAGATTTCGCGGGGGCAT|GCGCGATAAGACACGTGGGCCTGGCGGCAT
TGTAAACCTCCGGACTCCCGGCCGTAAACA|GCTGAACCAGTGCGAAACATGGTGGGAGTA
TTACCCACTGGAATATGAGGTCTGACAGTA|AGCGCCGGGCCTTGATCGGGACCTGGTGGT
GCTGACTTACGTTGTAGACGCAGAGAAATC|CCACAGGTGGAAGTGTAAACGAGCGCGATA
TCACTCTCTACCACATTCGGAACCACCGGC|ACTCGTACCGATTGTTCGTCAAGCCCCTGA
CCCACAGGTGGAAGTGTAAACATGGTTCCC|TGGTTCCCACAGGTGGAAGTGTAAACAGTT
GGTCACTCTCTACCACATTCGGAACCACCG|CGACTCGTACCGATTGTTCGTCAAGCCCCT
GTCTAACGGTCCCTCAGGTTCCTTCTCGAG|GTGGAAGTGTAAACCCACAGGTGGAAGTGT
AGGTTCTTATGCCAGATATGATGAATAGGC|CCTAAGGGCATGGTTCCCACAGGTGGAAGT
TCTATACGCCCGCTGACTTACGTTGTAGAC|AGGCATGGTTCCCACAGGTGGAAGTGTAAA
GCGTAAAATTACGCTTACCCACTGGAATAT|TAAACCGTGTGGAAAGCGCCGGGCCTTGAT
CTCGATATGCTCGCAATTTATCTACCAGCA|AATAGAGACGGTAGCGTGAGGGCATGGTTC
GTACCGATTGTTCGTCAAGCCCCTGACACC|TTCCATAGGTTCTTATGCCAGATATGATGA
TAATTGTTGTGTTTAACATGTTTGGGGATA|TAAACGAACATTATACACCGTCCCCTTCGT
GTACCACACTATAGGAGAAATTTACTATCC|GGTGGAAGTGTAAACACCCCGGGTCCCCTG
CAGCCTCTGCTGAACCAGTGCGAAACATGG|ATGGTTCCCACAGGTGGAAGTGTAAACTGG
ATAGGAGAAATTTACTATCCCCGGTTATCA|TAAACACCCCGGGTCCCCTGTTGACGGCAC
CCACAGGTGGAAGTGTAAACCGTGTGGAAA|ACTGATCTATACGCCCGCTGACTTACGTTG
CATACGGACACATCTTCTGTACCCTATCAC|CACAGGTGGAAGTGTAAACCCTTCCCTGCG
AGGGCATGGTTCCCACAGGTGGAAGTGTAA|TCCTTCTCGAGCGTAAAATTACGCTTACCC
TCTACCAGCACCATAGTACCACACTATAGG|GGCATGGTTCCCACAGGTGGAAGTGTAAAC
CGCTTACCCACTGGAATATGAGGTCTGACA|GAAAGCGCCGGGCCTTGATCGGGACCTGGT
ACGCTTACCCACTGGAATATGAGGTCTGAC|GGAAAGCGCCGGGCCTTGATCGGGACCTGG
GGGGGGGATGGCACATCTTTAATTGTTGTG|GTTCCCACAGGTGGAAGTGTAAACGAACAT
AACGAACATTATACACCGTCCCCTTCGTTC|TATCGGGCATGGTTCCCACAGGTGGAAGTG
ATGGTGGGAGTAAAGAAGGCATGGTTCCCA|CTGGACCTCTATATGCTGACTAAAAACTGA
TGGTTCCCACAGGTGGAAGTGTAAACAGAA|CACCCGTCGAATCGTTAAAGATCAGGCCTC
AGTACCACACTATAGGAGAAATTTACTATC|AGGTGGAAGTGTAAACACCCCGGGTCCCCT
TATATGCTGACTAAAAACTGAATCAGTCAT|CACATTCGGAACCACCGGCATGGTTCCCAC
GTGGAAGTGTAAACGAGCGCGATAAGACAC|AGTCATACGGACACATCTTCTGTACCCTAT
ACCACATTCGGAACCACCGGCATGGTTCCC|GATTGTTCGTCAAGCCCCTGACACCCCCTT
TTAAAAGCGGCAAACCTATATCTGGCATGG|CGCTAGTATCAGGATGCTTATTGAAGCCCG
GATCGGGACCTGGTGGTCTCGAGTGTTGAC|AATCCGCACAGATTTCGCGGGGGCATGGTT
CCCACAGGTGGAAGTGTAAACTACTAACGG|CTGGGCATGGTTCGGCATGGTTCCCACAGG
ACTGAATCAGTCATACGGACACATCTTCTG|GGCATGGTTCCCACAGGTGGAAGTGTAAAC
TAAAAGCGGCAAACCTATATCTGGCATGGT|GCTAGTATCAGGATGCTTATTGAAGCCCGG
ACTAACGGTCTAACGGTCCCTCAGGTTCCT|CCCACAGGTGGAAGTGTAAACCCACAGGTG
AAGTGTAAACCCTTCCCTGCGCCCGCGAAG|GTCTTAAAAGCGGCAAACCTATATCTGGCA
CTGGGCCGCGTCTGGTTCCCTGGGCATGGT|TGACGCCAAAGGCATGGTTCCCACAGGTGG
GTTGTGTTTAACATGTTTGGGGATACGACT|GAACATTATACACCGTCCCCTTCGTTCCGC
CGCCCGCGAAGATGGGGGGGATGGCACATC|TATATCTGGCATGGTTCCCACAGGTGGAAG
CATGGTTCCCACAGGTGGAAGTGTAAACGA|CTAAAAACTGAATCAGTCATACGGACACAT
GCCCCTGACACCCCCTTAAGTGCTAGTCTT|CAGATATGATGAATAGGCCACCCTTGAGCG
GGATGCTTATTGAAGCCCGGGACGCACTCC|CGAGAGTGCGGTCAAGAGGAGGTGTCCTTG
CGCGGCATGGTTCCCACAGGTGGAAGTGTA|GCGTCTGGTTCCCTGGGCATGGTTCGGCAT
TGTTTAACATGTTTGGGGATACGACTCGTA|ATTATACACCGTCCCCTTCGTTCCGCCTTC
CCATAGTACCACACTATAGGAGAAATTTAC|CCACAGGTGGAAGTGTAAACACCCCGGGTC
GGTGGAAGTGTAAACCGTGTGGAAAGCGCC|TCTATACGCCCGCTGACTTACGTTGTAGAC
ATTCCAGGCATGGTTCCCACAGGTGGAAGT|CATGGTTCCCACAGGTGGAAGTGTAAACTA
CATGGTTCCCACAGGTGGAAGTGTAAACCA|CATGGTTCCCACAGGTGGAAGTGTAAACAT
CCCACAGGTGGAAGTGTAAACCGTGTGGAA|CACTGATCTATACGCCCGCTGACTTACGTT
CCCTCAGGTTCCTTCTCGAGCGTAAAATTA|AAACCCACAGGTGGAAGTGTAAACCGTGTG
GTGTAAACCTCCGGACTCCCGGCCGTAAAC|TGCTGAACCAGTGCGAAACATGGTGGGAGT
CATGGTTCCCACAGGTGGAAGTGTAAACGA|GCCCGGGACGCACTCCGGAATAATGTATCG
GACGCCAAAGGCATGGTTCCCACAGGTGGA|GTTCCCACAGGTGGAAGTGTAAACCAGCCT
AGCCCCTGACACCCCCTTAAGTGCTAGTCT|CCAGATATGATGAATAGGCCACCCTTGAGC
CCCACAGGTGGAAGTGTAAACCTCCGGACT|GTAAACCAGCCTCTGCTGAACCAGTGCGAA
TGTAAACGAACATTATACACCGTCCCCTTC|AATGTATCGGGCATGGTTCCCACAGGTGGA
CAGATTTCGCGGGGGCATGGTTCCCACAGG|ACGTGGGCCTGGCGGCATGGTTCCCACAGG
CACATTCGGAACCACCGGCATGGTTCCCAC|TTGTTCGTCAAGCCCCTGACACCCCCTTAA
GCATGGTTCCCACAGGTGGAAGTGTAAACA|TTCTCGAGCGTAAAATTACGCTTACCCACT
CAGAGAAATCCGCACAGATTTCGCGGGGGC|GAGCGCGATAAGACACGTGGGCCTGGCGGC
TATTGAAGCCCGGGACGCACTCCGGAATAA|GCGGTCAAGAGGAGGTGTCCTTGGATCGTC
GATGGCACATCTTTAATTGTTGTGTTTAAC|ACAGGTGGAAGTGTAAACGAACATTATACA
ACAGGTGGAAGTGTAAACCGTGTGGAAAGC|TGATCTATACGCCCGCTGACTTACGTTGTA
TATGCCAGATATGATGAATAGGCCACCCTT|GCATGGTTCCCACAGGTGGAAGTGTAAACA
GGACGCACTCCGGAATAATGTATCGGGCAT|AGGTGTCCTTGGATCGTCGCTGATGCCGAC
GCGCCGGGCCTTGATCGGGACCTGGTGGTC|TAGACGCAGAGAAATCCGCACAGATTTCGC
AAGTGTAAACCTCCGGACTCCCGGCCGTAA|TCTGCTGAACCAGTGCGAAACATGGTGGGA
ATGATGAATAGGCCACCCTTGAGCGCTAGT|CACAGGTGGAAGTGTAAACAAATGTGGGGA
GATCCAGCTAAGGTCACTCTCTACCACATT|GTTTGGGGATACGACTCGTACCGATTGTTC
CCCTGCGCCCGCGAAGATGGGGGGGATGGC|AAACCTATATCTGGCATGGTTCCCACAGGT
TCTCGAGTGTTGACGCCAAAGGCATGGTTC|GCGGGGGCATGGTTCCCACAGGTGGAAGTG
AGCGCGATAAGACACGTGGGCCTGGCGGCA|TCTTCTGTACCCTATCACCTACCCTTCTTC
ACCGGCATGGTTCCCACAGGTGGAAGTGTA|CCCTGACACCCCCTTAAGTGCTAGTCTTAA
AGCGCTAGTATCAGGATGCTTATTGAAGCC|ATGTGGGGAAGAGCGAGAGTGCGGTCAAGA
GGTCTAACGGTCCCTCAGGTTCCTTCTCGA|GGTGGAAGTGTAAACCCACAGGTGGAAGTG
TTATCTACCAGCACCATAGTACCACACTAT|GAGGGCATGGTTCCCACAGGTGGAAGTGTA
GGAGTAAAGAAGGCATGGTTCCCACAGGTG|CTCTATATGCTGACTAAAAACTGAATCAGT
ACACCCCGGGTCCCCTGTTGACGGCACACA|ACTGGAATATGAGGTCTGACAGTATGCATC
GTAGCGTGAGGGCATGGTTCCCACAGGTGG|CCTCAGGTTCCTTCTCGAGCGTAAAATTAC
ACAGGTGGAAGTGTAAACGAACATTATACA|CACTCCGGAATAATGTATCGGGCATGGTTC
GTTCCGATCCAGCTAAGGTCACTCTCTACC|AACATGTTTGGGGATACGACTCGTACCGAT
CGCGAAGATGGGGGGGATGGCACATCTTTA|TCTGGCATGGTTCCCACAGGTGGAAGTGTA
AGGCATGGTTCCCACAGGTGGAAGTGTAAA|GGGGGGATGGCACATCTTTAATTGTTGTGT
GGTTCCCACAGGTGGAAGTGTAAACCCACA|AACCTCCGGACTCCCGGCCGTAAACACTGA
ATGGTTCGGCATGGTTCCCACAGGTGGAAG|GGTGGAAGTGTAAACCTCCGGACTCCCGGC
TGGTTCCCACAGGTGGAAGTGTAAACGAAC|CCGGGACGCACTCCGGAATAATGTATCGGG
TTGTAGACGCAGAGAAATCCGCACAGATTT|AGTGTAAACGAGCGCGATAAGACACGTGGG
CGCCGGGCCTTGATCGGGACCTGGTGGTCT|AGACGCAGAGAAATCCGCACAGATTTCGCG
GTGTAAACCCTTCCCTGCGCCCGCGAAGAT|CTTAAAAGCGGCAAACCTATATCTGGCATG
AGCGCCATGTCTATGACATTCCAGGCATGG|CAGCGATCTCCTCGCGGCATGGTTCCCACA
GAAAGCGCCGGGCCTTGATCGGGACCTGGT|GTTGTAGACGCAGAGAAATCCGCACAGATT
ACTCGTACCGATTGTTCGTCAAGCCCCTGA|CGCCTTCCATAGGTTCTTATGCCAGATATG
ACCGTCCCCTTCGTTCCGCCTTCCATAGGT|CCCACAGGTGGAAGTGTAAACAGAACCCTA
GTTTAACATGTTTGGGGATACGACTCGTAC|TTATACACCGTCCCCTTCGTTCCGCCTTCC
TCGGAACCACCGGCATGGTTCCCACAGGTG|CGTCAAGCCCCTGACACCCCCTTAAGTGCT
GCGCTAGTATCAGGATGCTTATTGAAGCCC|TGTGGGGAAGAGCGAGAGTGCGGTCAAGAG
TAAGGTCACTCTCTACCACATTCGGAACCA|ATACGACTCGTACCGATTGTTCGTCAAGCC
ATTATACACCGTCCCCTTCGTTCCGCCTTC|CATGGTTCCCACAGGTGGAAGTGTAAACAG
CACAGGTGGAAGTGTAAACACCCCGGGTCC|TAAAATTACGCTTACCCACTGGAATATGAG
CAAAGGCATGGTTCCCACAGGTGGAAGTGT|CACAGGTGGAAGTGTAAACCAGCCTCTGCT
GTAAACGAACATTATACACCGTCCCCTTCG|ATGTATCGGGCATGGTTCCCACAGGTGGAA
CGTGTGGAAAGCGCCGGGCCTTGATCGGGA|ACTTACGTTGTAGACGCAGAGAAATCCGCA
GGGGATACGACTCGTACCGATTGTTCGTCA|CCTTCGTTCCGCCTTCCATAGGTTCTTATG
ATGGTTCCCACAGGTGGAAGTGTAAACCAG|ATGGTTCCCACAGGTGGAAGTGTAAACATG
TGCTAGTCTTAAAAGCGGCAAACCTATATC|CCCTTGAGCGCTAGTATCAGGATGCTTATT
TGATCGGGACCTGGTGGTCTCGAGTGTTGA|AAATCCGCACAGATTTCGCGGGGGCATGGT
CCTGGCGGCATGGTTCCCACAGGTGGAAGT|ACCCTTCTTCAGGCATGGTTCCCACAGGTG
CATGGTGGGAGTAAAGAAGGCATGGTTCCC|ACTGGACCTCTATATGCTGACTAAAAACTG
ACATTCCAGGCATGGTTCCCACAGGTGGAA|GGCATGGTTCCCACAGGTGGAAGTGTAAAC
ATTTATCTACCAGCACCATAGTACCACACT|GTGAGGGCATGGTTCCCACAGGTGGAAGTG
GTTATCAGAGCGCCATGTCTATGACATTCC|ACGGCACACAGCGATCTCCTCGCGGCATGG
TATGACATTCCAGGCATGGTTCCCACAGGT|TCGCGGCATGGTTCCCACAGGTGGAAGTGT
AATTTACTATCCCCGGTTATCAGAGCGCCA|CCGGGTCCCCTGTTGACGGCACACAGCGAT
AACATTATACACCGTCCCCTTCGTTCCGCC|GGGCATGGTTCCCACAGGTGGAAGTGTAAA
AAATCCGCACAGATTTCGCGGGGGCATGGT|CGATAAGACACGTGGGCCTGGCGGCATGGT
GAACCAGTGCGAAACATGGTGGGAGTAAAG|AGGTGGAAGTGTAAACTGGACCTCTATATG
CAGGTGGAAGTGTAAACACCCCGGGTCCCC|AAATTACGCTTACCCACTGGAATATGAGGT
CTTACCCACTGGAATATGAGGTCTGACAGT|AAGCGCCGGGCCTTGATCGGGACCTGGTGG
GGTTCCCACAGGTGGAAGTGTAAACGAGCG|AAAACTGAATCAGTCATACGGACACATCTT
CTAGTATCAGGATGCTTATTGAAGCCCGGG|GGGGAAGAGCGAGAGTGCGGTCAAGAGGAG
CGTACCGATTGTTCGTCAAGCCCCTGACAC|CTTCCATAGGTTCTTATGCCAGATATGATG
TTTCGCGGGGGCATGGTTCCCACAGGTGGA|GGGCCTGGCGGCATGGTTCCCACAGGTGGA
GAATAGGCCACCCTTGAGCGCTAGTATCAG|GTGGAAGTGTAAACAAATGTGGGGAAGAGC
CGTTGTAGACGCAGAGAAATCCGCACAGAT|GAAGTGTAAACGAGCGCGATAAGACACGTG
CTGTTGACGGCACACAGCGATCTCCTCGCG|TCTGACAGTATGCATCTGCCTGGGCCGCGT
GTGTAAACGAACATTATACACCGTCCCCTT|TAATGTATCGGGCATGGTTCCCACAGGTGG
GGACACATCTTCTGTACCCTATCACCTACC|GTGGAAGTGTAAACCCTTCCCTGCGCCCGC
CCTTCTTCAGGCATGGTTCCCACAGGTGGA|CGAAGATGGGGGGGATGGCACATCTTTAAT
CTGAATCAGTCATACGGACACATCTTCTGT|GCATGGTTCCCACAGGTGGAAGTGTAAACC
ACCAGTGCGAAACATGGTGGGAGTAAAGAA|GTGGAAGTGTAAACTGGACCTCTATATGCT
ATGGTTCCCACAGGTGGAAGTGTAAACGAA|CCCGGGACGCACTCCGGAATAATGTATCGG
TTCTTATGCCAGATATGATGAATAGGCCAC|AAGGGCATGGTTCCCACAGGTGGAAGTGTA
GATTTCGCGGGGGCATGGTTCCCACAGGTG|GTGGGCCTGGCGGCATGGTTCCCACAGGTG
AGAAATTTACTATCCCCGGTTATCAGAGCG|ACCCCGGGTCCCCTGTTGACGGCACACAGC
CCCCGGTTATCAGAGCGCCATGTCTATGAC|TGTTGACGGCACACAGCGATCTCCTCGCGG
AGCCCGGGACGCACTCCGGAATAATGTATC|AAGAGGAGGTGTCCTTGGATCGTCGCTGAT
GTAAACACTGATCTATACGCCCGCTGACTT|GGGAGTAAAGAAGGCATGGTTCCCACAGGT
GAGCGCCATGTCTATGACATTCCAGGCATG|ACAGCGATCTCCTCGCGGCATGGTTCCCAC
ACAGGTGGAAGTGTAAACCAGCCTCTGCTG|ACAGGTGGAAGTGTAAACATGGTTCCCACA
GTGGTCTCGAGTGTTGACGCCAAAGGCATG|TTTCGCGGGGGCATGGTTCCCACAGGTGGA
CATGGTTCCCACAGGTGGAAGTGTAAACAG|GGGATGGCACATCTTTAATTGTTGTGTTTA
ATAGGCCACCCTTGAGCGCTAGTATCAGGA|GGAAGTGTAAACAAATGTGGGGAAGAGCGA
ACTGATCTATACGCCCGCTGACTTACGTTG|AAAGAAGGCATGGTTCCCACAGGTGGAAGT
TGGAAGTGTAAACTGGACCTCTATATGCTG|CCAGCTAAGGTCACTCTCTACCACATTCGG
TAAGACACGTGGGCCTGGCGGCATGGTTCC|TACCCTATCACCTACCCTTCTTCAGGCATG
TTTACTATCCCCGGTTATCAGAGCGCCATG|GGGTCCCCTGTTGACGGCACACAGCGATCT
GCCATGTCTATGACATTCCAGGCATGGTTC|CGATCTCCTCGCGGCATGGTTCCCACAGGT
ATGCTCGCAATTTATCTACCAGCACCATAG|GACGGTAGCGTGAGGGCATGGTTCCCACAG
GGAAGTGTAAACGAACATTATACACCGTCC|GGAATAATGTATCGGGCATGGTTCCCACAG
CAAATAGAGACGGTAGCGTGAGGGCATGGT|GGTCTAACGGTCCCTCAGGTTCCTTCTCGA
GTTCCCACAGGTGGAAGTGTAAACTGGACC|ACAGTTCCGATCCAGCTAAGGTCACTCTCT
CCGCACAGATTTCGCGGGGGCATGGTTCCC|AAGACACGTGGGCCTGGCGGCATGGTTCCC
GCCGGGCCTTGATCGGGACCTGGTGGTCTC|GACGCAGAGAAATCCGCACAGATTTCGCGG
CCTTGAGCGCTAGTATCAGGATGCTTATTG|AACAAATGTGGGGAAGAGCGAGAGTGCGGT
GGTGGAAGTGTAAACTACTAACGGTCTAAC|ATGGTTCGGCATGGTTCCCACAGGTGGAAG
GTGGGAGTAAAGAAGGCATGGTTCCCACAG|GACCTCTATATGCTGACTAAAAACTGAATC
TCTGGTTCCCTGGGCATGGTTCGGCATGGT|GGCATGGTTCCCACAGGTGGAAGTGTAAAC
CGGTAGCGTGAGGGCATGGTTCCCACAGGT|TCCCTCAGGTTCCTTCTCGAGCGTAAAATT
TGGTTCCCACAGGTGGAAGTGTAAACCCTT|ACCCCCTTAAGTGCTAGTCTTAAAAGCGGC
TGACAGTATGCATCTGCCTGGGCCGCGTCT|CTGGTGGTCTCGAGTGTTGACGCCAAAGGC
TCTTCAGGCATGGTTCCCACAGGTGGAAGT|AGATGGGGGGGATGGCACATCTTTAATTGT
GAAGTGTAAACAGTTCCGATCCAGCTAAGG|ATTGTTGTGTTTAACATGTTTGGGGATACG
GGAAGTGTAAACGAGCGCGATAAGACACGT|TCATACGGACACATCTTCTGTACCCTATCA
TCCGGAATAATGTATCGGGCATGGTTCCCA|TTGGATCGTCGCTGATGCCGACACCCGTCG
GCCCGCTGACTTACGTTGTAGACGCAGAGA|GTTCCCACAGGTGGAAGTGTAAACGAGCGC
CTTTAATTGTTGTGTTTAACATGTTTGGGG|GTGTAAACGAACATTATACACCGTCCCCTT
CGAAACATGGTGGGAGTAAAGAAGGCATGG|TGTAAACTGGACCTCTATATGCTGACTAAA
TCCCACAGGTGGAAGTGTAAACCTCCGGAC|TGTAAACCAGCCTCTGCTGAACCAGTGCGA
AGTGCTAGTCTTAAAAGCGGCAAACCTATA|CACCCTTGAGCGCTAGTATCAGGATGCTTA
CTGCCTGGGCCGCGTCTGGTTCCCTGGGCA|GTGTTGACGCCAAAGGCATGGTTCCCACAG
CATGGTTCCCACAGGTGGAAGTGTAAACAG|GACACCCGTCGAATCGTTAAAGATCAGGCC
GAAGTGTAAACGAACATTATACACCGTCCC|GAATAATGTATCGGGCATGGTTCCCACAGG
CCCCTTAAGTGCTAGTCTTAAAAGCGGCAA|AATAGGCCACCCTTGAGCGCTAGTATCAGG
ACGCCCGCTGACTTACGTTGTAGACGCAGA|TGGTTCCCACAGGTGGAAGTGTAAACGAGC
AAGGCATGGTTCCCACAGGTGGAAGTGTAA|CTGACTAAAAACTGAATCAGTCATACGGAC
CCAGCCTCTGCTGAACCAGTGCGAAACATG|CATGGTTCCCACAGGTGGAAGTGTAAACTG
ATCTATACGCCCGCTGACTTACGTTGTAGA|AAGGCATGGTTCCCACAGGTGGAAGTGTAA
TACTAACGGTCTAACGGTCCCTCAGGTTCC|TCCCACAGGTGGAAGTGTAAACCCACAGGT
AGTGTAAACTGGACCTCTATATGCTGACTA|CTAAGGTCACTCTCTACCACATTCGGAACC
GTGGAAGTGTAAACATGGTTCCCACAGGTG|CACAGGTGGAAGTGTAAACAGTTCCGATCC
AAATAGAGACGGTAGCGTGAGGGCATGGTT|GTCTAACGGTCCCTCAGGTTCCTTCTCGAG
GGTTCCCACAGGTGGAAGTGTAAACATGGT|GGCATGGTTCCCACAGGTGGAAGTGTAAAC
GCTGACTAAAAACTGAATCAGTCATACGGA|TCGGAACCACCGGCATGGTTCCCACAGGTG
GATTACTCGATATGCTCGCAATTTATCTAC|AAACAAATAGAGACGGTAGCGTGAGGGCAT
TGGAAGTGTAAACAAATAGAGACGGTAGCG|TAAACTACTAACGGTCTAACGGTCCCTCAG
CGCGATAAGACACGTGGGCCTGGCGGCATG|TTCTGTACCCTATCACCTACCCTTCTTCAG
GAAATTTACTATCCCCGGTTATCAGAGCGC|CCCCGGGTCCCCTGTTGACGGCACACAGCG
GGAAAGCGCCGGGCCTTGATCGGGACCTGG|CGTTGTAGACGCAGAGAAATCCGCACAGAT
GGGCATGGTTCGGCATGGTTCCCACAGGTG|CACAGGTGGAAGTGTAAACCTCCGGACTCC
GTCACTCTCTACCACATTCGGAACCACCGG|GACTCGTACCGATTGTTCGTCAAGCCCCTG
TGTCTATGACATTCCAGGCATGGTTCCCAC|CTCCTCGCGGCATGGTTCCCACAGGTGGAA
CTCTGCTGAACCAGTGCGAAACATGGTGGG|TTCCCACAGGTGGAAGTGTAAACTGGACCT
CCCTGTTGACGGCACACAGCGATCTCCTCG|GGTCTGACAGTATGCATCTGCCTGGGCCGC
GAAGTGTAAACCTCCGGACTCCCGGCCGTA|CTCTGCTGAACCAGTGCGAAACATGGTGGG
AATTACGCTTACCCACTGGAATATGAGGTC|GTGTGGAAAGCGCCGGGCCTTGATCGGGAC
AGTGTTGACGCCAAAGGCATGGTTCCCACA|GGCATGGTTCCCACAGGTGGAAGTGTAAAC
CACAGGTGGAAGTGTAAACAGTTCCGATCC|CATCTTTAATTGTTGTGTTTAACATGTTTG
GGTGGAAGTGTAAACCCTTCCCTGCGCCCG|TGCTAGTCTTAAAAGCGGCAAACCTATATC
GGTGGAAGTGTAAACCTCCGGACTCCCGGC|CAGCCTCTGCTGAACCAGTGCGAAACATGG
CCAGGCATGGTTCCCACAGGTGGAAGTGTA|GGTTCCCACAGGTGGAAGTGTAAACTACTA
AAACAAATAGAGACGGTAGCGTGAGGGCAT|AACGGTCTAACGGTCCCTCAGGTTCCTTCT
CCCTATCACCTACCCTTCTTCAGGCATGGT|TTCCCTGCGCCCGCGAAGATGGGGGGGATG
GTAAACGAGCGCGATAAGACACGTGGGCCT|GGACACATCTTCTGTACCCTATCACCTACC
ACGTTGTAGACGCAGAGAAATCCGCACAGA|GGAAGTGTAAACGAGCGCGATAAGACACGT
TTACGTTGTAGACGCAGAGAAATCCGCACA|GTGGAAGTGTAAACGAGCGCGATAAGACAC
GCGATAAGACACGTGGGCCTGGCGGCATGG|TCTGTACCCTATCACCTACCCTTCTTCAGG
AACATGGTGGGAGTAAAGAAGGCATGGTTC|AAACTGGACCTCTATATGCTGACTAAAAAC
GGACTCCCGGCCGTAAACACTGATCTATAC|GCGAAACATGGTGGGAGTAAAGAAGGCATG
ACCTACCCTTCTTCAGGCATGGTTCCCACA|CGCCCGCGAAGATGGGGGGGATGGCACATC
TAAGTGCTAGTCTTAAAAGCGGCAAACCTA|GCCACCCTTGAGCGCTAGTATCAGGATGCT
TATGCTGACTAAAAACTGAATCAGTCATAC|CATTCGGAACCACCGGCATGGTTCCCACAG
ACAGGTGGAAGTGTAAACAAATAGAGACGG|AAGTGTAAACTACTAACGGTCTAACGGTCC
GCCCGGGACGCACTCCGGAATAATGTATCG|AGAGGAGGTGTCCTTGGATCGTCGCTGATG
AGTATGCATCTGCCTGGGCCGCGTCTGGTT|TGGTCTCGAGTGTTGACGCCAAAGGCATGG
CAGTGCGAAACATGGTGGGAGTAAAGAAGG|GGAAGTGTAAACTGGACCTCTATATGCTGA
GTGGAAAGCGCCGGGCCTTGATCGGGACCT|TACGTTGTAGACGCAGAGAAATCCGCACAG
GAAGTGTAAACATGGTTCCCACAGGTGGAA|AGGTGGAAGTGTAAACAGTTCCGATCCAGC
ACAGGTGGAAGTGTAAACCCTTCCCTGCGC|AAGTGCTAGTCTTAAAAGCGGCAAACCTAT
GGAAGTGTAAACCAGCCTCTGCTGAACCAG|GGAAGTGTAAACATGGTTCCCACAGGTGGA
GCCACCCTTGAGCGCTAGTATCAGGATGCT|GTGTAAACAAATGTGGGGAAGAGCGAGAGT
AAACATGGTTCCCACAGGTGGAAGTGTAAA|AGTGTAAACAGTTCCGATCCAGCTAAGGTC
TTCCCACAGGTGGAAGTGTAAACCAGCCTC|TTCCCACAGGTGGAAGTGTAAACATGGTTC
GGGGATGGCACATCTTTAATTGTTGTGTTT|CCCACAGGTGGAAGTGTAAACGAACATTAT
CACAGGTGGAAGTGTAAACTGGACCTCTAT|TCCGATCCAGCTAAGGTCACTCTCTACCAC
CCACATTCGGAACCACCGGCATGGTTCCCA|ATTGTTCGTCAAGCCCCTGACACCCCCTTA
ACCCTATCACCTACCCTTCTTCAGGCATGG|CTTCCCTGCGCCCGCGAAGATGGGGGGGAT
GGCATGGTTCCCACAGGTGGAAGTGTAAAC|GACTAAAAACTGAATCAGTCATACGGACAC
AAACATGGTGGGAGTAAAGAAGGCATGGTT|TAAACTGGACCTCTATATGCTGACTAAAAA
TGGTTCCCACAGGTGGAAGTGTAAACATGG|AGGCATGGTTCCCACAGGTGGAAGTGTAAA
CGCCAAAGGCATGGTTCCCACAGGTGGAAG|TCCCACAGGTGGAAGTGTAAACCAGCCTCT
TCCCTGCGCCCGCGAAGATGGGGGGGATGG|CAAACCTATATCTGGCATGGTTCCCACAGG
CAGGTGGAAGTGTAAACCAGCCTCTGCTGA|CAGGTGGAAGTGTAAACATGGTTCCCACAG
TGGTTCCCACAGGTGGAAGTGTAAACACCC|TCGAGCGTAAAATTACGCTTACCCACTGGA
GGACCTCTATATGCTGACTAAAAACTGAAT|TCTCTACCACATTCGGAACCACCGGCATGG
TTCTGTACCCTATCACCTACCCTTCTTCAG|TAAACCCTTCCCTGCGCCCGCGAAGATGGG
CTTGATCGGGACCTGGTGGTCTCGAGTGTT|AGAAATCCGCACAGATTTCGCGGGGGCATG
ACATTATACACCGTCCCCTTCGTTCCGCCT|GGCATGGTTCCCACAGGTGGAAGTGTAAAC
CGTTCCGCCTTCCATAGGTTCTTATGCCAG|AAGTGTAAACAGAACCCTAAGGGCATGGTT
CCCTTAAGTGCTAGTCTTAAAAGCGGCAAA|ATAGGCCACCCTTGAGCGCTAGTATCAGGA
CCATAGGTTCTTATGCCAGATATGATGAAT|GAACCCTAAGGGCATGGTTCCCACAGGTGG
CACAGGTGGAAGTGTAAACAAATAGAGACG|GAAGTGTAAACTACTAACGGTCTAACGGTC
TCCAGGCATGGTTCCCACAGGTGGAAGTGT|TGGTTCCCACAGGTGGAAGTGTAAACTACT
GTGTAAACTACTAACGGTCTAACGGTCCCT|GGCATGGTTCCCACAGGTGGAAGTGTAAAC
AGCGTGAGGGCATGGTTCCCACAGGTGGAA|TCAGGTTCCTTCTCGAGCGTAAAATTACGC
GAGTAAAGAAGGCATGGTTCCCACAGGTGG|TCTATATGCTGACTAAAAACTGAATCAGTC
GGAAGTGTAAACTACTAACGGTCTAACGGT|GTTCGGCATGGTTCCCACAGGTGGAAGTGT
CTCCGGACTCCCGGCCGTAAACACTGATCT|CAGTGCGAAACATGGTGGGAGTAAAGAAGG
GTGCGAAACATGGTGGGAGTAAAGAAGGCA|AAGTGTAAACTGGACCTCTATATGCTGACT
ACATCTTCTGTACCCTATCACCTACCCTTC|AAGTGTAAACCCTTCCCTGCGCCCGCGAAG
ATGGTTCCCACAGGTGGAAGTGTAAACCCT|CACCCCCTTAAGTGCTAGTCTTAAAAGCGG
GCCCGCGAAGATGGGGGGGATGGCACATCT|ATATCTGGCATGGTTCCCACAGGTGGAAGT
GCATGGTTCGGCATGGTTCCCACAGGTGGA|CAGGTGGAAGTGTAAACCTCCGGACTCCCG
ATCAGTCATACGGACACATCTTCTGTACCC|GGTTCCCACAGGTGGAAGTGTAAACCCTTC
ATAGGTTCTTATGCCAGATATGATGAATAG|ACCCTAAGGGCATGGTTCCCACAGGTGGAA
TTACTCGATATGCTCGCAATTTATCTACCA|ACAAATAGAGACGGTAGCGTGAGGGCATGG
CCCACAGGTGGAAGTGTAAACAGAACCCTA|GTCGAATCGTTAAAGATCAGGCCTCAATGG
CATTCGGAACCACCGGCATGGTTCCCACAG|GTTCGTCAAGCCCCTGACACCCCCTTAAGT
CTTATGCCAGATATGATGAATAGGCCACCC|GGGCATGGTTCCCACAGGTGGAAGTGTAAA
CCAGATATGATGAATAGGCCACCCTTGAGC|GGTTCCCACAGGTGGAAGTGTAAACAAATG
CCTTGATCGGGACCTGGTGGTCTCGAGTGT|GAGAAATCCGCACAGATTTCGCGGGGGCAT
CGCCATGTCTATGACATTCCAGGCATGGTT|GCGATCTCCTCGCGGCATGGTTCCCACAGG
ATTTCGCGGGGGCATGGTTCCCACAGGTGG|TGGGCCTGGCGGCATGGTTCCCACAGGTGG
ATTACTCGATATGCTCGCAATTTATCTACC|AACAAATAGAGACGGTAGCGTGAGGGCATG
AGATGGGGGGGATGGCACATCTTTAATTGT|CATGGTTCCCACAGGTGGAAGTGTAAACGA
CCCACAGGTGGAAGTGTAAACACCCCGGGT|CGTAAAATTACGCTTACCCACTGGAATATG
CGGCAAACCTATATCTGGCATGGTTCCCAC|ATCAGGATGCTTATTGAAGCCCGGGACGCA
CCCTGACACCCCCTTAAGTGCTAGTCTTAA|GATATGATGAATAGGCCACCCTTGAGCGCT
AGATTACTCGATATGCTCGCAATTTATCTA|TAAACAAATAGAGACGGTAGCGTGAGGGCA
TCCCTCAGGTTCCTTCTCGAGCGTAAAATT|TAAACCCACAGGTGGAAGTGTAAACCGTGT
AGGTCTGACAGTATGCATCTGCCTGGGCCG|GGGACCTGGTGGTCTCGAGTGTTGACGCCA
ACCAGCACCATAGTACCACACTATAGGAGA|ATGGTTCCCACAGGTGGAAGTGTAAACACC
CGGGCATGGTTCCCACAGGTGGAAGTGTAA|TGCCGACACCCGTCGAATCGTTAAAGATCA
ATGGTTCCCACAGGTGGAAGTGTAAACTGG|TAAACAGTTCCGATCCAGCTAAGGTCACTC
GATCTATACGCCCGCTGACTTACGTTGTAG|GAAGGCATGGTTCCCACAGGTGGAAGTGTA
GAAATCCGCACAGATTTCGCGGGGGCATGG|GCGATAAGACACGTGGGCCTGGCGGCATGG
CTGACACCCCCTTAAGTGCTAGTCTTAAAA|TATGATGAATAGGCCACCCTTGAGCGCTAG
GTAGACGCAGAGAAATCCGCACAGATTTCG|TGTAAACGAGCGCGATAAGACACGTGGGCC
AAATTTACTATCCCCGGTTATCAGAGCGCC|CCCGGGTCCCCTGTTGACGGCACACAGCGA
ACCCTTGAGCGCTAGTATCAGGATGCTTAT|TAAACAAATGTGGGGAAGAGCGAGAGTGCG
TCATACGGACACATCTTCTGTACCCTATCA|CCACAGGTGGAAGTGTAAACCCTTCCCTGC
TTACGCTTACCCACTGGAATATGAGGTCTG|GTGGAAAGCGCCGGGCCTTGATCGGGACCT
ATTGTTCGTCAAGCCCCTGACACCCCCTTA|AGGTTCTTATGCCAGATATGATGAATAGGC
CGCACAGATTTCGCGGGGGCATGGTTCCCA|AGACACGTGGGCCTGGCGGCATGGTTCCCA
GCCAGATATGATGAATAGGCCACCCTTGAG|TGGTTCCCACAGGTGGAAGTGTAAACAAAT
GGTGGAAGTGTAAACATGGTTCCCACAGGT|CCACAGGTGGAAGTGTAAACAGTTCCGATC
TCTGGCATGGTTCCCACAGGTGGAAGTGTA|TTGAAGCCCGGGACGCACTCCGGAATAATG
GGCATGGTTCCCACAGGTGGAAGTGTAAAC|TCCCACAGGTGGAAGTGTAAACTACTAACG
CCCACAGGTGGAAGTGTAAACAGTTCCGAT|CACATCTTTAATTGTTGTGTTTAACATGTT
TTCCCTGGGCATGGTTCGGCATGGTTCCCA|GGTTCCCACAGGTGGAAGTGTAAACCTCCG
ATACGCCCGCTGACTTACGTTGTAGACGCA|CATGGTTCCCACAGGTGGAAGTGTAAACGA
ATGCATCTGCCTGGGCCGCGTCTGGTTCCC|TCTCGAGTGTTGACGCCAAAGGCATGGTTC
TCCCACAGGTGGAAGTGTAAACCCACAGGT|CTCCGGACTCCCGGCCGTAAACACTGATCT
CACAGCGATCTCCTCGCGGCATGGTTCCCA|CATCTGCCTGGGCCGCGTCTGGTTCCCTGG
TACCACACTATAGGAGAAATTTACTATCCC|GTGGAAGTGTAAACACCCCGGGTCCCCTGT
TGGACCTCTATATGCTGACTAAAAACTGAA|CTCTCTACCACATTCGGAACCACCGGCATG
TGCGAAACATGGTGGGAGTAAAGAAGGCAT|AGTGTAAACTGGACCTCTATATGCTGACTA
CCACAGGTGGAAGTGTAAACAGTTCCGATC|ACATCTTTAATTGTTGTGTTTAACATGTTT
AGAAGGCATGGTTCCCACAGGTGGAAGTGT|TGCTGACTAAAAACTGAATCAGTCATACGG
CTTAAGTGCTAGTCTTAAAAGCGGCAAACC|AGGCCACCCTTGAGCGCTAGTATCAGGATG
CGCTGACTTACGTTGTAGACGCAGAGAAAT|CCCACAGGTGGAAGTGTAAACGAGCGCGAT
TACCAGCACCATAGTACCACACTATAGGAG|CATGGTTCCCACAGGTGGAAGTGTAAACAC
GATGCTTATTGAAGCCCGGGACGCACTCCG|GAGAGTGCGGTCAAGAGGAGGTGTCCTTGG
TGTTCGTCAAGCCCCTGACACCCCCTTAAG|GTTCTTATGCCAGATATGATGAATAGGCCA
GCTAGTCTTAAAAGCGGCAAACCTATATCT|CCTTGAGCGCTAGTATCAGGATGCTTATTG
GGTTCCTTCTCGAGCGTAAAATTACGCTTA|ACAGGTGGAAGTGTAAACCGTGTGGAAAGC
TCTGCTGAACCAGTGCGAAACATGGTGGGA|TCCCACAGGTGGAAGTGTAAACTGGACCTC
CCACACTATAGGAGAAATTTACTATCCCCG|GGAAGTGTAAACACCCCGGGTCCCCTGTTG
CTAACGGTCCCTCAGGTTCCTTCTCGAGCG|GGAAGTGTAAACCCACAGGTGGAAGTGTAA
ATATGAGGTCTGACAGTATGCATCTGCCTG|TGATCGGGACCTGGTGGTCTCGAGTGTTGA
GTGGGCCTGGCGGCATGGTTCCCACAGGTG|CACCTACCCTTCTTCAGGCATGGTTCCCAC
GGGGGATGGCACATCTTTAATTGTTGTGTT|TCCCACAGGTGGAAGTGTAAACGAACATTA
CGCAGAGAAATCCGCACAGATTTCGCGGGG|ACGAGCGCGATAAGACACGTGGGCCTGGCG
TGTAGACGCAGAGAAATCCGCACAGATTTC|GTGTAAACGAGCGCGATAAGACACGTGGGC
AACTGGACCTCTATATGCTGACTAAAAACT|TCACTCTCTACCACATTCGGAACCACCGGC
GCCTTGATCGGGACCTGGTGGTCTCGAGTG|AGAGAAATCCGCACAGATTTCGCGGGGGCA
GACACCCCCTTAAGTGCTAGTCTTAAAAGC|TGATGAATAGGCCACCCTTGAGCGCTAGTA
TGGGGATACGACTCGTACCGATTGTTCGTC|CCCTTCGTTCCGCCTTCCATAGGTTCTTAT
CCACAGGTGGAAGTGTAAACCCACAGGTGG|CCGGACTCCCGGCCGTAAACACTGATCTAT
GAAGGCATGGTTCCCACAGGTGGAAGTGTA|GCTGACTAAAAACTGAATCAGTCATACGGA
TCCCACAGGTGGAAGTGTAAACAGAACCCT|CGTCGAATCGTTAAAGATCAGGCCTCAATG
TAAACTACTAACGGTCTAACGGTCCCTCAG|ATGGTTCCCACAGGTGGAAGTGTAAACCCA
CAGTATGCATCTGCCTGGGCCGCGTCTGGT|GTGGTCTCGAGTGTTGACGCCAAAGGCATG
TAAACCAGCCTCTGCTGAACCAGTGCGAAA|TAAACATGGTTCCCACAGGTGGAAGTGTAA
TCACCTACCCTTCTTCAGGCATGGTTCCCA|TGCGCCCGCGAAGATGGGGGGGATGGCACA
GGTTCCCACAGGTGGAAGTGTAAACCCTTC|CCCCCTTAAGTGCTAGTCTTAAAAGCGGCA
CTGCTGAACCAGTGCGAAACATGGTGGGAG|CCCACAGGTGGAAGTGTAAACTGGACCTCT
CTCGAGCGTAAAATTACGCTTACCCACTGG|AAGTGTAAACCGTGTGGAAAGCGCCGGGCC
GTGTTGACGCCAAAGGCATGGTTCCCACAG|GCATGGTTCCCACAGGTGGAAGTGTAAACC
CCACAGGTGGAAGTGTAAACTGGACCTCTA|TTCCGATCCAGCTAAGGTCACTCTCTACCA
GATGGGGGGGATGGCACATCTTTAATTGTT|ATGGTTCCCACAGGTGGAAGTGTAAACGAA
GGCATGGTTCCCACAGGTGGAAGTGTAAAC|CTTCAGGCATGGTTCCCACAGGTGGAAGTG
GCACACAGCGATCTCCTCGCGGCATGGTTC|ATGCATCTGCCTGGGCCGCGTCTGGTTCCC
AGTTCCGATCCAGCTAAGGTCACTCTCTAC|TAACATGTTTGGGGATACGACTCGTACCGA
CCCACAGGTGGAAGTGTAAACCCTTCCCTG|CTTAAGTGCTAGTCTTAAAAGCGGCAAACC
CATCTTCTGTACCCTATCACCTACCCTTCT|AGTGTAAACCCTTCCCTGCGCCCGCGAAGA
AAGTGTAAACGAGCGCGATAAGACACGTGG|ATACGGACACATCTTCTGTACCCTATCACC
TACTATCCCCGGTTATCAGAGCGCCATGTC|GTCCCCTGTTGACGGCACACAGCGATCTCC
GTTCCCACAGGTGGAAGTGTAAACCAGCCT|GTTCCCACAGGTGGAAGTGTAAACATGGTT
CAGCACCATAGTACCACACTATAGGAGAAA|GGTTCCCACAGGTGGAAGTGTAAACACCCC
TTCCCACAGGTGGAAGTGTAAACATGGTTC|CATGGTTCCCACAGGTGGAAGTGTAAACAG
TAACGGTCTAACGGTCCCTCAGGTTCCTTC|CACAGGTGGAAGTGTAAACCCACAGGTGGA
TATGCATCTGCCTGGGCCGCGTCTGGTTCC|GTCTCGAGTGTTGACGCCAAAGGCATGGTT
GGAAGTGTAAACCGTGTGGAAAGCGCCGGG|ATACGCCCGCTGACTTACGTTGTAGACGCA
CCTGGGCCGCGTCTGGTTCCCTGGGCATGG|TTGACGCCAAAGGCATGGTTCCCACAGGTG
AAGCCCCTGACACCCCCTTAAGTGCTAGTC|GCCAGATATGATGAATAGGCCACCCTTGAG
AACCTCCGGACTCCCGGCCGTAAACACTGA|AACCAGTGCGAAACATGGTGGGAGTAAAGA
AAAAGCGGCAAACCTATATCTGGCATGGTT|CTAGTATCAGGATGCTTATTGAAGCCCGGG
TGTTGTGTTTAACATGTTTGGGGATACGAC|CGAACATTATACACCGTCCCCTTCGTTCCG
TAAACCTCCGGACTCCCGGCCGTAAACACT|TGAACCAGTGCGAAACATGGTGGGAGTAAA
CCCACAGGTGGAAGTGTAAACTGGACCTCT|GTTCCGATCCAGCTAAGGTCACTCTCTACC
ATGCCAGATATGATGAATAGGCCACCCTTG|CATGGTTCCCACAGGTGGAAGTGTAAACAA
GACTAAAAACTGAATCAGTCATACGGACAC|GAACCACCGGCATGGTTCCCACAGGTGGAA
GCCTTCCATAGGTTCTTATGCCAGATATGA|AAACAGAACCCTAAGGGCATGGTTCCCACA
CAGGATGCTTATTGAAGCCCGGGACGCACT|AGCGAGAGTGCGGTCAAGAGGAGGTGTCCT
GATCTCCTCGCGGCATGGTTCCCACAGGTG|CCTGGGCCGCGTCTGGTTCCCTGGGCATGG
GGAAGTGTAAACCTCCGGACTCCCGGCCGT|CCTCTGCTGAACCAGTGCGAAACATGGTGG
GCATCTGCCTGGGCCGCGTCTGGTTCCCTG|TCGAGTGTTGACGCCAAAGGCATGGTTCCC
GGAAGTGTAAACTGGACCTCTATATGCTGA|CAGCTAAGGTCACTCTCTACCACATTCGGA
GAAGTGTAAACCCTTCCCTGCGCCCGCGAA|AGTCTTAAAAGCGGCAAACCTATATCTGGC
GGCAAACCTATATCTGGCATGGTTCCCACA|TCAGGATGCTTATTGAAGCCCGGGACGCAC
TTCAGGCATGGTTCCCACAGGTGGAAGTGT|ATGGGGGGGATGGCACATCTTTAATTGTTG
CGGTCTAACGGTCCCTCAGGTTCCTTCTCG|AGGTGGAAGTGTAAACCCACAGGTGGAAGT
TGTAAACTACTAACGGTCTAACGGTCCCTC|GCATGGTTCCCACAGGTGGAAGTGTAAACC
GATTGTTCGTCAAGCCCCTGACACCCCCTT|TAGGTTCTTATGCCAGATATGATGAATAGG
CTCGTACCGATTGTTCGTCAAGCCCCTGAC|GCCTTCCATAGGTTCTTATGCCAGATATGA
CACTCCGGAATAATGTATCGGGCATGGTTC|TCCTTGGATCGTCGCTGATGCCGACACCCG
ACAGCGATCTCCTCGCGGCATGGTTCCCAC|ATCTGCCTGGGCCGCGTCTGGTTCCCTGGG
CTTGAGCGCTAGTATCAGGATGCTTATTGA|ACAAATGTGGGGAAGAGCGAGAGTGCGGTC
CAGCTAAGGTCACTCTCTACCACATTCGGA|GGGGATACGACTCGTACCGATTGTTCGTCA
AGACACGTGGGCCTGGCGGCATGGTTCCCA|CCCTATCACCTACCCTTCTTCAGGCATGGT
GCGGCATGGTTCCCACAGGTGGAAGTGTAA|TTCTTCAGGCATGGTTCCCACAGGTGGAAG
TCAGGATGCTTATTGAAGCCCGGGACGCAC|GAGCGAGAGTGCGGTCAAGAGGAGGTGTCC
ACAAATAGAGACGGTAGCGTGAGGGCATGG|CGGTCTAACGGTCCCTCAGGTTCCTTCTCG
ACGGTCCCTCAGGTTCCTTCTCGAGCGTAA|AGTGTAAACCCACAGGTGGAAGTGTAAACC
TATACACCGTCCCCTTCGTTCCGCCTTCCA|TGGTTCCCACAGGTGGAAGTGTAAACAGAA
AGGTGGAAGTGTAAACCCTTCCCTGCGCCC|GTGCTAGTCTTAAAAGCGGCAAACCTATAT
AGGCATGGTTCCCACAGGTGGAAGTGTAAA|TTCCCACAGGTGGAAGTGTAAACTACTAAC
ATCAGGATGCTTATTGAAGCCCGGGACGCA|AGAGCGAGAGTGCGGTCAAGAGGAGGTGTC
GAAGCCCGGGACGCACTCCGGAATAATGTA|TCAAGAGGAGGTGTCCTTGGATCGTCGCTG
ATGGTTCCCACAGGTGGAAGTGTAAACAGT|GGATGGCACATCTTTAATTGTTGTGTTTAA
TCTATGACATTCCAGGCATGGTTCCCACAG|CCTCGCGGCATGGTTCCCACAGGTGGAAGT
TTCCCTGCGCCCGCGAAGATGGGGGGGATG|GCAAACCTATATCTGGCATGGTTCCCACAG
CTAAGGTCACTCTCTACCACATTCGGAACC|GATACGACTCGTACCGATTGTTCGTCAAGC
ACAGTATGCATCTGCCTGGGCCGCGTCTGG|GGTGGTCTCGAGTGTTGACGCCAAAGGCAT
GGTTCCCACAGGTGGAAGTGTAAACGAACA|CGGGACGCACTCCGGAATAATGTATCGGGC
TGACACCCCCTTAAGTGCTAGTCTTAAAAG|ATGATGAATAGGCCACCCTTGAGCGCTAGT
TAGAGACGGTAGCGTGAGGGCATGGTTCCC|TAACGGTCCCTCAGGTTCCTTCTCGAGCGT
CCTATATCTGGCATGGTTCCCACAGGTGGA|TGCTTATTGAAGCCCGGGACGCACTCCGGA
ATGGTTCCCACAGGTGGAAGTGTAAACATG|CAGGCATGGTTCCCACAGGTGGAAGTGTAA
ACACGTGGGCCTGGCGGCATGGTTCCCACA|CTATCACCTACCCTTCTTCAGGCATGGTTC
CATGGTTCCCACAGGTGGAAGTGTAAACTA|TGGTTCCCTGGGCATGGTTCGGCATGGTTC
GGTTCCCACAGGTGGAAGTGTAAACCTCCG|AAGTGTAAACCAGCCTCTGCTGAACCAGTG
GTTCCCACAGGTGGAAGTGTAAACAGAACC|CCCGTCGAATCGTTAAAGATCAGGCCTCAA
AATATGAGGTCTGACAGTATGCATCTGCCT|TTGATCGGGACCTGGTGGTCTCGAGTGTTG
GGCGGCATGGTTCCCACAGGTGGAAGTGTA|CTTCTTCAGGCATGGTTCCCACAGGTGGAA
CTTCTCGAGCGTAAAATTACGCTTACCCAC|TGGAAGTGTAAACCGTGTGGAAAGCGCCGG
AACTGAATCAGTCATACGGACACATCTTCT|CGGCATGGTTCCCACAGGTGGAAGTGTAAA
GTAAACCGTGTGGAAAGCGCCGGGCCTTGA|CCGCTGACTTACGTTGTAGACGCAGAGAAA
TTCCCACAGGTGGAAGTGTAAACCCTTCCC|CCCTTAAGTGCTAGTCTTAAAAGCGGCAAA
GGTGGAAGTGTAAACCCACAGGTGGAAGTG|CTCCCGGCCGTAAACACTGATCTATACGCC
TACCCACTGGAATATGAGGTCTGACAGTAT|GCGCCGGGCCTTGATCGGGACCTGGTGGTC
ACAGGTGGAAGTGTAAACACCCCGGGTCCC|AAAATTACGCTTACCCACTGGAATATGAGG
GTTGACGGCACACAGCGATCTCCTCGCGGC|TGACAGTATGCATCTGCCTGGGCCGCGTCT
GAACATTATACACCGTCCCCTTCGTTCCGC|CGGGCATGGTTCCCACAGGTGGAAGTGTAA
CATCTTTAATTGTTGTGTTTAACATGTTTG|GAAGTGTAAACGAACATTATACACCGTCCC
GCACATCTTTAATTGTTGTGTTTAACATGT|GTGGAAGTGTAAACGAACATTATACACCGT
GCCTCTGCTGAACCAGTGCGAAACATGGTG|GGTTCCCACAGGTGGAAGTGTAAACTGGAC
ATGGCACATCTTTAATTGTTGTGTTTAACA|CAGGTGGAAGTGTAAACGAACATTATACAC
GGGCCGCGTCTGGTTCCCTGGGCATGGTTC|ACGCCAAAGGCATGGTTCCCACAGGTGGAA
TACCCTATCACCTACCCTTCTTCAGGCATG|CCTTCCCTGCGCCCGCGAAGATGGGGGGGA
ACCTCTATATGCTGACTAAAAACTGAATCA|TCTACCACATTCGGAACCACCGGCATGGTT
CTTCCATAGGTTCTTATGCCAGATATGATG|ACAGAACCCTAAGGGCATGGTTCCCACAGG
GGTTCCCACAGGTGGAAGTGTAAACACCCC|CGAGCGTAAAATTACGCTTACCCACTGGAA
ATTCGGAACCACCGGCATGGTTCCCACAGG|TTCGTCAAGCCCCTGACACCCCCTTAAGTG
GGCACATCTTTAATTGTTGTGTTTAACATG|GGTGGAAGTGTAAACGAACATTATACACCG
CAGCGATCTCCTCGCGGCATGGTTCCCACA|TCTGCCTGGGCCGCGTCTGGTTCCCTGGGC
TAGGTTCTTATGCCAGATATGATGAATAGG|CCCTAAGGGCATGGTTCCCACAGGTGGAAG
GTCTTAAAAGCGGCAAACCTATATCTGGCA|GAGCGCTAGTATCAGGATGCTTATTGAAGC
TGGAAGTGTAAACCCACAGGTGGAAGTGTA|CCCGGCCGTAAACACTGATCTATACGCCCG
CTCAGGTTCCTTCTCGAGCGTAAAATTACG|ACCCACAGGTGGAAGTGTAAACCGTGTGGA
AGCGCCGGGCCTTGATCGGGACCTGGTGGT|GTAGACGCAGAGAAATCCGCACAGATTTCG
GTGGAAGTGTAAACTACTAACGGTCTAACG|TGGTTCGGCATGGTTCCCACAGGTGGAAGT
ATCGGGACCTGGTGGTCTCGAGTGTTGACG|ATCCGCACAGATTTCGCGGGGGCATGGTTC
AGGTGGAAGTGTAAACGAACATTATACACC|CTCCGGAATAATGTATCGGGCATGGTTCCC
GAGGGCATGGTTCCCACAGGTGGAAGTGTA|TTCCTTCTCGAGCGTAAAATTACGCTTACC
TCCGCACAGATTTCGCGGGGGCATGGTTCC|TAAGACACGTGGGCCTGGCGGCATGGTTCC
CGTGGGCCTGGCGGCATGGTTCCCACAGGT|TCACCTACCCTTCTTCAGGCATGGTTCCCA
TCCCACAGGTGGAAGTGTAAACATGGTTCC|ATGGTTCCCACAGGTGGAAGTGTAAACAGT
AAGTGTAAACTGGACCTCTATATGCTGACT|GCTAAGGTCACTCTCTACCACATTCGGAAC
AACCAGTGCGAAACATGGTGGGAGTAAAGA|GGTGGAAGTGTAAACTGGACCTCTATATGC
GAAGATGGGGGGGATGGCACATCTTTAATT|GGCATGGTTCCCACAGGTGGAAGTGTAAAC
CGCCTTCCATAGGTTCTTATGCCAGATATG|TAAACAGAACCCTAAGGGCATGGTTCCCAC
GGAACCACCGGCATGGTTCCCACAGGTGGA|TCAAGCCCCTGACACCCCCTTAAGTGCTAG
TCCCACAGGTGGAAGTGTAAACTACTAACG|CCTGGGCATGGTTCGGCATGGTTCCCACAG
GCCGCGTCTGGTTCCCTGGGCATGGTTCGG|GCCAAAGGCATGGTTCCCACAGGTGGAAGT
ATAGAGACGGTAGCGTGAGGGCATGGTTCC|CTAACGGTCCCTCAGGTTCCTTCTCGAGCG
GGTTCCCTGGGCATGGTTCGGCATGGTTCC|ATGGTTCCCACAGGTGGAAGTGTAAACCTC
TGAACCAGTGCGAAACATGGTGGGAGTAAA|CAGGTGGAAGTGTAAACTGGACCTCTATAT
TCCCACAGGTGGAAGTGTAAACTGGACCTC|AGTTCCGATCCAGCTAAGGTCACTCTCTAC
GTTCCCACAGGTGGAAGTGTAAACTACTAA|TCCCTGGGCATGGTTCGGCATGGTTCCCAC
GGTTCCCACAGGTGGAAGTGTAAACAAATA|CAGGTGGAAGTGTAAACTACTAACGGTCTA
GATGAATAGGCCACCCTTGAGCGCTAGTAT|CAGGTGGAAGTGTAAACAAATGTGGGGAAG
CCTTAAGTGCTAGTCTTAAAAGCGGCAAAC|TAGGCCACCCTTGAGCGCTAGTATCAGGAT
TACCACATTCGGAACCACCGGCATGGTTCC|CGATTGTTCGTCAAGCCCCTGACACCCCCT
TTCTTCAGGCATGGTTCCCACAGGTGGAAG|AAGATGGGGGGGATGGCACATCTTTAATTG
CCCTTCTTCAGGCATGGTTCCCACAGGTGG|GCGAAGATGGGGGGGATGGCACATCTTTAA
ACCACACTATAGGAGAAATTTACTATCCCC|TGGAAGTGTAAACACCCCGGGTCCCCTGTT
GCCGTAAACACTGATCTATACGCCCGCTGA|GGTGGGAGTAAAGAAGGCATGGTTCCCACA
AAGTGTAAACTACTAACGGTCTAACGGTCC|TCGGCATGGTTCCCACAGGTGGAAGTGTAA
TGACTTACGTTGTAGACGCAGAGAAATCCG|ACAGGTGGAAGTGTAAACGAGCGCGATAAG
TGGAATATGAGGTCTGACAGTATGCATCTG|GCCTTGATCGGGACCTGGTGGTCTCGAGTG
TTACTATCCCCGGTTATCAGAGCGCCATGT|GGTCCCCTGTTGACGGCACACAGCGATCTC
GTTCCCACAGGTGGAAGTGTAAACCTCCGG|AGTGTAAACCAGCCTCTGCTGAACCAGTGC
ATCCCCGGTTATCAGAGCGCCATGTCTATG|CCTGTTGACGGCACACAGCGATCTCCTCGC
TGGAAGTGTAAACAGTTCCGATCCAGCTAA|TAATTGTTGTGTTTAACATGTTTGGGGATA
TATCAGAGCGCCATGTCTATGACATTCCAG|GGCACACAGCGATCTCCTCGCGGCATGGTT
TTCCGATCCAGCTAAGGTCACTCTCTACCA|ACATGTTTGGGGATACGACTCGTACCGATT
TTCCAGGCATGGTTCCCACAGGTGGAAGTG|ATGGTTCCCACAGGTGGAAGTGTAAACTAC
TAGTATCAGGATGCTTATTGAAGCCCGGGA|GGGAAGAGCGAGAGTGCGGTCAAGAGGAGG
ACCGATTGTTCGTCAAGCCCCTGACACCCC|CCATAGGTTCTTATGCCAGATATGATGAAT
TTCCTTCTCGAGCGTAAAATTACGCTTACC|AGGTGGAAGTGTAAACCGTGTGGAAAGCGC
TTGAGCGCTAGTATCAGGATGCTTATTGAA|CAAATGTGGGGAAGAGCGAGAGTGCGGTCA
GGGATGGCACATCTTTAATTGTTGTGTTTA|CCACAGGTGGAAGTGTAAACGAACATTATA
GTGTTTAACATGTTTGGGGATACGACTCGT|CATTATACACCGTCCCCTTCGTTCCGCCTT
TTATCAGAGCGCCATGTCTATGACATTCCA|CGGCACACAGCGATCTCCTCGCGGCATGGT
TGCATCTGCCTGGGCCGCGTCTGGTTCCCT|CTCGAGTGTTGACGCCAAAGGCATGGTTCC
GTAAACCCTTCCCTGCGCCCGCGAAGATGG|TAAAAGCGGCAAACCTATATCTGGCATGGT
TGGGCATGGTTCGGCATGGTTCCCACAGGT|CCACAGGTGGAAGTGTAAACCTCCGGACTC
CACCGGCATGGTTCCCACAGGTGGAAGTGT|CCCCTGACACCCCCTTAAGTGCTAGTCTTA
AGGCATGGTTCCCACAGGTGGAAGTGTAAA|AGGTGGAAGTGTAAACCAGCCTCTGCTGAA
TAAACAAATAGAGACGGTAGCGTGAGGGCA|TAACGGTCTAACGGTCCCTCAGGTTCCTTC
ATTACGCTTACCCACTGGAATATGAGGTCT|TGTGGAAAGCGCCGGGCCTTGATCGGGACC
GTGGAAGTGTAAACCCACAGGTGGAAGTGT|TCCCGGCCGTAAACACTGATCTATACGCCC
TCGCGGGGGCATGGTTCCCACAGGTGGAAG|GCCTGGCGGCATGGTTCCCACAGGTGGAAG
TTCCCACAGGTGGAAGTGTAAACAAATAGA|GGTGGAAGTGTAAACTACTAACGGTCTAAC
TATCCCCGGTTATCAGAGCGCCATGTCTAT|CCCTGTTGACGGCACACAGCGATCTCCTCG
ATGTCTATGACATTCCAGGCATGGTTCCCA|TCTCCTCGCGGCATGGTTCCCACAGGTGGA
TGCCTGGGCCGCGTCTGGTTCCCTGGGCAT|TGTTGACGCCAAAGGCATGGTTCCCACAGG
ATCACCTACCCTTCTTCAGGCATGGTTCCC|CTGCGCCCGCGAAGATGGGGGGGATGGCAC
AATCCGCACAGATTTCGCGGGGGCATGGTT|GATAAGACACGTGGGCCTGGCGGCATGGTT
GGCACACAGCGATCTCCTCGCGGCATGGTT|TATGCATCTGCCTGGGCCGCGTCTGGTTCC
TGTAAACATGGTTCCCACAGGTGGAAGTGT|GGAAGTGTAAACAGTTCCGATCCAGCTAAG
TGGCATGGTTCCCACAGGTGGAAGTGTAAA|GAAGCCCGGGACGCACTCCGGAATAATGTA
CACATCTTTAATTGTTGTGTTTAACATGTT|TGGAAGTGTAAACGAACATTATACACCGTC
GCTGAACCAGTGCGAAACATGGTGGGAGTA|CACAGGTGGAAGTGTAAACTGGACCTCTAT
GGTGGAAGTGTAAACTGGACCTCTATATGC|ATCCAGCTAAGGTCACTCTCTACCACATTC
GCGGCATGGTTCCCACAGGTGGAAGTGTAA|CGTCTGGTTCCCTGGGCATGGTTCGGCATG
CACAGGTGGAAGTGTAAACCAGCCTCTGCT|CACAGGTGGAAGTGTAAACATGGTTCCCAC
AGTGTAAACGAGCGCGATAAGACACGTGGG|TACGGACACATCTTCTGTACCCTATCACCT
AAACGAACATTATACACCGTCCCCTTCGTT|GTATCGGGCATGGTTCCCACAGGTGGAAGT
TGGTTCGGCATGGTTCCCACAGGTGGAAGT|GTGGAAGTGTAAACCTCCGGACTCCCGGCC
ACTCCGGAATAATGTATCGGGCATGGTTCC|CCTTGGATCGTCGCTGATGCCGACACCCGT
AAAACTGAATCAGTCATACGGACACATCTT|ACCGGCATGGTTCCCACAGGTGGAAGTGTA
AAACAGTTCCGATCCAGCTAAGGTCACTCT|TGTTTAACATGTTTGGGGATACGACTCGTA
TCCCACAGGTGGAAGTGTAAACCCTTCCCT|CCTTAAGTGCTAGTCTTAAAAGCGGCAAAC
TGACGGCACACAGCGATCTCCTCGCGGCAT|ACAGTATGCATCTGCCTGGGCCGCGTCTGG
AAGCGCCGGGCCTTGATCGGGACCTGGTGG|TGTAGACGCAGAGAAATCCGCACAGATTTC
AAGATGGGGGGGATGGCACATCTTTAATTG|GCATGGTTCCCACAGGTGGAAGTGTAAACG
GGTTCCCACAGGTGGAAGTGTAAACCAGCC|GGTTCCCACAGGTGGAAGTGTAAACATGGT
ATATGATGAATAGGCCACCCTTGAGCGCTA|CCCACAGGTGGAAGTGTAAACAAATGTGGG
TGGTTCCCACAGGTGGAAGTGTAAACCAGC|TGGTTCCCACAGGTGGAAGTGTAAACATGG
GCTTACCCACTGGAATATGAGGTCTGACAG|AAAGCGCCGGGCCTTGATCGGGACCTGGTG
AAAGAAGGCATGGTTCCCACAGGTGGAAGT|TATGCTGACTAAAAACTGAATCAGTCATAC
CACAGGTGGAAGTGTAAACCTCCGGACTCC|AAACCAGCCTCTGCTGAACCAGTGCGAAAC
CGACTCGTACCGATTGTTCGTCAAGCCCCT|TCCGCCTTCCATAGGTTCTTATGCCAGATA
CTCCTCGCGGCATGGTTCCCACAGGTGGAA|GGGCCGCGTCTGGTTCCCTGGGCATGGTTC
GAAGTGTAAACGAGCGCGATAAGACACGTG|CATACGGACACATCTTCTGTACCCTATCAC
CTCTATATGCTGACTAAAAACTGAATCAGT|TACCACATTCGGAACCACCGGCATGGTTCC
ATACGGACACATCTTCTGTACCCTATCACC|ACAGGTGGAAGTGTAAACCCTTCCCTGCGC
ACAGGTGGAAGTGTAAACCCACAGGTGGAA|GGACTCCCGGCCGTAAACACTGATCTATAC
AGCGATCTCCTCGCGGCATGGTTCCCACAG|CTGCCTGGGCCGCGTCTGGTTCCCTGGGCA
TCGGGACCTGGTGGTCTCGAGTGTTGACGC|TCCGCACAGATTTCGCGGGGGCATGGTTCC
TAGTCTTAAAAGCGGCAAACCTATATCTGG|TTGAGCGCTAGTATCAGGATGCTTATTGAA
GACGGTAGCGTGAGGGCATGGTTCCCACAG|GGTCCCTCAGGTTCCTTCTCGAGCGTAAAA
TGAGGGCATGGTTCCCACAGGTGGAAGTGT|GTTCCTTCTCGAGCGTAAAATTACGCTTAC
CGTGAGGGCATGGTTCCCACAGGTGGAAGT|AGGTTCCTTCTCGAGCGTAAAATTACGCTT
CATGGTTCCCACAGGTGGAAGTGTAAACAT|TCAGGCATGGTTCCCACAGGTGGAAGTGTA
GCGGGGGCATGGTTCCCACAGGTGGAAGTG|CTGGCGGCATGGTTCCCACAGGTGGAAGTG
AATTTATCTACCAGCACCATAGTACCACAC|CGTGAGGGCATGGTTCCCACAGGTGGAAGT
TGTAAACCAGCCTCTGCTGAACCAGTGCGA|TGTAAACATGGTTCCCACAGGTGGAAGTGT
GAAACATGGTGGGAGTAAAGAAGGCATGGT|GTAAACTGGACCTCTATATGCTGACTAAAA
TAAACCCACAGGTGGAAGTGTAAACCGTGT|TAAACACTGATCTATACGCCCGCTGACTTA
GTTCCCACAGGTGGAAGTGTAAACATGGTT|GCATGGTTCCCACAGGTGGAAGTGTAAACA
ACTTACGTTGTAGACGCAGAGAAATCCGCA|AGGTGGAAGTGTAAACGAGCGCGATAAGAC
CCTCAGGTTCCTTCTCGAGCGTAAAATTAC|AACCCACAGGTGGAAGTGTAAACCGTGTGG
GGAATATGAGGTCTGACAGTATGCATCTGC|CCTTGATCGGGACCTGGTGGTCTCGAGTGT
ACGGCACACAGCGATCTCCTCGCGGCATGG|AGTATGCATCTGCCTGGGCCGCGTCTGGTT
GATACGACTCGTACCGATTGTTCGTCAAGC|TCGTTCCGCCTTCCATAGGTTCTTATGCCA
TGTTGACGCCAAAGGCATGGTTCCCACAGG|CATGGTTCCCACAGGTGGAAGTGTAAACCA
ATTGAAGCCCGGGACGCACTCCGGAATAAT|CGGTCAAGAGGAGGTGTCCTTGGATCGTCG
ACATGGTTCCCACAGGTGGAAGTGTAAACT|TGTAAACAGTTCCGATCCAGCTAAGGTCAC
GAGCGCGATAAGACACGTGGGCCTGGCGGC|ATCTTCTGTACCCTATCACCTACCCTTCTT
AGGTTCCTTCTCGAGCGTAAAATTACGCTT|CACAGGTGGAAGTGTAAACCGTGTGGAAAG
CCACAGGTGGAAGTGTAAACCCTTCCCTGC|TTAAGTGCTAGTCTTAAAAGCGGCAAACCT
CATAGTACCACACTATAGGAGAAATTTACT|CACAGGTGGAAGTGTAAACACCCCGGGTCC
AGCACCATAGTACCACACTATAGGAGAAAT|GTTCCCACAGGTGGAAGTGTAAACACCCCG
GATAAGACACGTGGGCCTGGCGGCATGGTT|TGTACCCTATCACCTACCCTTCTTCAGGCA
GACTTACGTTGTAGACGCAGAGAAATCCGC|CAGGTGGAAGTGTAAACGAGCGCGATAAGA
TATACGCCCGCTGACTTACGTTGTAGACGC|GCATGGTTCCCACAGGTGGAAGTGTAAACG
CCGGGCCTTGATCGGGACCTGGTGGTCTCG|ACGCAGAGAAATCCGCACAGATTTCGCGGG
TAGGCCACCCTTGAGCGCTAGTATCAGGAT|GAAGTGTAAACAAATGTGGGGAAGAGCGAG
ACCTCCGGACTCCCGGCCGTAAACACTGAT|ACCAGTGCGAAACATGGTGGGAGTAAAGAA
AGATTTCGCGGGGGCATGGTTCCCACAGGT|CGTGGGCCTGGCGGCATGGTTCCCACAGGT
CAGGTGGAAGTGTAAACCGTGTGGAAAGCG|GATCTATACGCCCGCTGACTTACGTTGTAG
GTTCCCACAGGTGGAAGTGTAAACGAGCGC|AAACTGAATCAGTCATACGGACACATCTTC
GACACATCTTCTGTACCCTATCACCTACCC|TGGAAGTGTAAACCCTTCCCTGCGCCCGCG
AGATATGATGAATAGGCCACCCTTGAGCGC|TTCCCACAGGTGGAAGTGTAAACAAATGTG
GAAGTGTAAACCGTGTGGAAAGCGCCGGGC|TACGCCCGCTGACTTACGTTGTAGACGCAG
CTTATTGAAGCCCGGGACGCACTCCGGAAT|GTGCGGTCAAGAGGAGGTGTCCTTGGATCG
AACCGTGTGGAAAGCGCCGGGCCTTGATCG|CTGACTTACGTTGTAGACGCAGAGAAATCC
ATCTACCAGCACCATAGTACCACACTATAG|GGGCATGGTTCCCACAGGTGGAAGTGTAAA
GGGGGGATGGCACATCTTTAATTGTTGTGT|TTCCCACAGGTGGAAGTGTAAACGAACATT
TACTCGATATGCTCGCAATTTATCTACCAG|CAAATAGAGACGGTAGCGTGAGGGCATGGT
GTGGAAGTGTAAACTGGACCTCTATATGCT|TCCAGCTAAGGTCACTCTCTACCACATTCG
CAGGCATGGTTCCCACAGGTGGAAGTGTAA|GGGGGGGATGGCACATCTTTAATTGTTGTG
CCGTAAACACTGATCTATACGCCCGCTGAC|GTGGGAGTAAAGAAGGCATGGTTCCCACAG
CCTGGTGGTCTCGAGTGTTGACGCCAAAGG|CAGATTTCGCGGGGGCATGGTTCCCACAGG
TAAACCGTGTGGAAAGCGCCGGGCCTTGAT|CGCTGACTTACGTTGTAGACGCAGAGAAAT
TCCGCCTTCCATAGGTTCTTATGCCAGATA|TGTAAACAGAACCCTAAGGGCATGGTTCCC
TAAAGAAGGCATGGTTCCCACAGGTGGAAG|ATATGCTGACTAAAAACTGAATCAGTCATA
CAGGTGGAAGTGTAAACCTCCGGACTCCCG|ACCAGCCTCTGCTGAACCAGTGCGAAACAT
AGTGCGAAACATGGTGGGAGTAAAGAAGGC|GAAGTGTAAACTGGACCTCTATATGCTGAC
TAAAAACTGAATCAGTCATACGGACACATC|CCACCGGCATGGTTCCCACAGGTGGAAGTG
AGGTGGAAGTGTAAACCAGCCTCTGCTGAA|AGGTGGAAGTGTAAACATGGTTCCCACAGG
TACCCTTCTTCAGGCATGGTTCCCACAGGT|CCGCGAAGATGGGGGGGATGGCACATCTTT
GCTCGCAATTTATCTACCAGCACCATAGTA|CGGTAGCGTGAGGGCATGGTTCCCACAGGT
CTTCCCTGCGCCCGCGAAGATGGGGGGGAT|GGCAAACCTATATCTGGCATGGTTCCCACA
AAACGAGCGCGATAAGACACGTGGGCCTGG|ACACATCTTCTGTACCCTATCACCTACCCT
TGGTTCCCACAGGTGGAAGTGTAAACTGGA|AAACAGTTCCGATCCAGCTAAGGTCACTCT
